0字节	0位元組
0杆	0桿
1字节	1位元組
1杆	1桿
2字节	2位元組
2杆	2桿
3字节	3位元組
3杆	3桿
4字节	4位元組
4杆	4桿
5字节	5位元組
5杆	5桿
6字节	6位元組
6杆	6桿
7字节	7位元組
7杆	7桿
8字节	8位元組
8杆	8桿
9字节	9位元組
9杆	9桿
甲型肝炎	A型肝炎
甲肝	A肝
乙型肝炎	B型肝炎
乙肝	B肝
丙型肝炎	C型肝炎
丙肝	C肝
IP地址	IP位址
乔戈里峰	K2
·威尔士	·威爾士
·威爾士	·威爾士
一杆	一桿
七杆	七桿
三杆	三桿
三极管	三極體
三極管	三極體
达累斯萨拉姆	三蘭港
上落客	上下客
上樑	上梁
下樑	下梁
落車	下車
卑詩省	不列顛哥倫比亞省
不來梅	不萊梅
不来梅	不萊梅
幺	么
以太网	乙太網
九杆	九桿
了結他	了結他
二手烟	二手菸
二手煙	二手菸
二杆	二桿
二极管	二極體
二極管	二極體
交互设计	互動設計
五杆	五桿
阿塞拜疆	亞塞拜然
阿斯旺	亞斯文
亚里士多德	亞里斯多德
亞里士多德	亞里斯多德
人工智能	人工智慧
人机交互	人機互動
行人路	人行道
石勒苏益格	什勒斯維希
石勒蘇益格	什勒斯維希
伊利诺伊州	伊利諾州
伊斯坦布尔	伊斯坦堡
伊斯坦布爾	伊斯坦堡
伊斯兰堡	伊斯蘭瑪巴德
伊斯蘭堡	伊斯蘭瑪巴德
埃博拉	伊波拉
伊丽莎白	伊莉莎白
俯卧撑	伏地挺身
掌上壓	伏地挺身
伯明翰	伯明罕
服务器	伺服器
佛罗伦萨	佛羅倫斯
操作系统	作業系統
系数	係數
避孕套	保險套
傅里叶	傅立葉
光盘	光碟
光驱	光碟機
开普勒	克卜勒
開普勒	克卜勒
克罗地亚	克羅埃西亞
克羅地亞	克羅埃西亞
克里斯托弗	克里斯多福
全角	全形
万维网	全球資訊網
全角度	全角度
全角色	全角色
八杆	八桿
公共交通	公共運輸
六杆	六桿
凯瑟琳	凱薩琳
嘉芙蓮	凱薩琳
划着独木舟	划着獨木舟
划着竹筏	划着竹筏
划着船	划着船
打印	列印
列支敦士登	列支敦斯登
前波美拉尼亚	前波莫瑞
前波美拉尼亞	前波莫瑞
加蓬	加彭
加泰罗尼亚	加泰隆尼亞
加泰羅尼亞	加泰隆尼亞
加沙地带	加薩走廊
加沙地帶	加薩走廊
包豪斯	包浩斯
局域网	區域網
局域网络	區域網路
十杆	十桿
特立尼达和多巴哥	千里達及托巴哥
特立尼達和多巴哥	千里達及托巴哥
南斯拉夫联盟共和国	南斯拉夫聯邦共和國
南斯拉夫聯盟共和國	南斯拉夫聯邦共和國
卡斯特罗	卡斯楚
卡塔尔	卡達
卡塔爾	卡達
铆足	卯足
打印机	印表機
打印機	印表機
厄利垂亚	厄利垂亞
厄立特里亚	厄利垂亞
厄立特里亞	厄利垂亞
厄瓜多	厄瓜多
厄瓜多尔	厄瓜多
厄瓜多爾	厄瓜多
源代码	原始碼
圆珠笔	原子筆
反烟	反菸
反煙	反菸
可卡因	古柯鹼
便携式	可攜式
叱咤	叱吒
叱咤9	叱咤9
叱咤M	叱咤M
叱咤叱	叱咤叱
叱咤咤	叱咤咤
叱咤樂壇	叱咤樂壇
斯坦福大学	史丹福大學
斯皮尔伯格	史匹柏
斯特劳斯	史特勞斯
斯威士兰	史瓦帝尼
斯威士蘭	史瓦帝尼
斯蒂芬	史蒂芬
斯大林	史達林
斯科普里	史高比耶
士碌架	司諾克
斯诺克	司諾克
結他	吉他
乞力馬札羅	吉力馬札羅
乞力马扎罗	吉力馬札羅
吉布堤	吉布地
吉布提	吉布地
基里巴斯	吉里巴斯
图瓦卢	吐瓦魯
圖瓦盧	吐瓦魯
吸烟	吸菸
吸煙	吸菸
吕宋烟	呂宋菸
呂宋煙	呂宋菸
格丁根	哥廷根
哥特式	哥德式
哥斯达黎加	哥斯大黎加
哥斯達黎加	哥斯大黎加
唐纳德·特朗普	唐納·川普
當勞·特朗普	唐納·川普
當奴·特朗普	唐納·川普
卡拉奇	喀拉蚩
乔治·奥威尔	喬治·歐威爾
佐治亚	喬治亞
佐治亞	喬治亞
格魯吉亞	喬治亞
格鲁吉亚	喬治亞
单反相机	單眼相機
單鏡反光機	單眼相機
嘯咤	嘯吒
四杆	四桿
圈樑	圈梁
图卢兹	土魯斯
圖盧茲	土魯斯
戛纳	坎城
堪培拉	坎培拉
坦桑尼亚	坦尚尼亞
坦桑尼亞	坦尚尼亞
端口	埠
首席执行官	執行長
报道	報導
塑料袋	塑膠袋
塞舌尔	塞席爾
塞舌爾	塞席爾
萨拉热窝	塞拉耶佛
薩拉熱窩	塞拉耶佛
塞尔维亚和黑山	塞爾維亞與蒙特內哥羅
塞爾維亞和黑山	塞爾維亞與蒙特內哥羅
塞爾維亞與蒙特內哥羅	塞爾維亞與蒙特內哥羅
塞维利亚	塞維亞
西維爾	塞維亞
塞黑	塞蒙
多美和普林西比	多美普林西比
塔希提	大溪地
共和联邦	大英國協
英联邦	大英國協
英聯邦	大英國協
太空飛行員	太空人
宇航员	太空人
穿梭機	太空梭
航天飞机	太空梭
宇航服	太空衣
航天器	太空飛行器
尼日利亚	奈及利亞
尼日利亞	奈及利亞
內羅畢	奈洛比
内罗毕	奈洛比
奥拉夫·朔尔茨	奧拉夫·蕭茲
奧拉夫·朔爾茨	奧拉夫·蕭茲
忌廉	奶油
荷里活	好萊塢
威廉姆斯	威廉士
威斯特法伦	威斯伐倫
威斯特法倫	威斯伐倫
威士顿康星	威斯康辛
威尔士	威爾斯
威爾士	威爾斯
西部数据	威騰電子
存盘	存檔
孟德爾遜	孟德爾頌
门德尔松	孟德爾頌
安哈尔特	安哈特
安哈爾特	安哈特
安提瓜	安地卡
安提瓜和巴布达	安地卡及巴布達
安提瓜和巴布達	安地卡及巴布達
洪都拉斯	宏都拉斯
宿务	宿霧
密歇根	密西根
老挝人民民主共和国	寮人民民主共和國
老撾人民民主共和國	寮人民民主共和國
老挝保护国	寮保護國
老撾保護國	寮保護國
老挝	寮國
老撾	寮國
老挝语	寮語
老撾語	寮語
波里活	寶萊塢
对着干	對着幹
高峰时段	尖峰時段
高峰时间	尖峰時間
贊比亞	尚比亞
赞比亚	尚比亞
尼克松	尼克森
尼日尔	尼日
尼日爾	尼日
屋樑	屋梁
山樑	山梁
雅马哈	山葉
巴厘	峇里
特朗普	川普
机床	工具機
機床	工具機
珍寶客機	巨無霸客機
巴塞罗那	巴塞隆納
巴塞隆拿	巴塞隆納
巴士拉	巴斯拉
巴巴多斯	巴貝多
布基納法索	布吉納法索
布基纳法索	布吉納法索
布什	布希
布殊	布希
布拉迪斯拉发	布拉提斯拉瓦
布拉迪斯拉發	布拉提斯拉瓦
勃兰登堡	布蘭登堡
勃蘭登堡	布蘭登堡
布里斯托尔	布里斯托
布隆方丹	布隆泉
希拉克略	希拉克略
希拉莉	希拉蕊
希拉里	希拉蕊
希特拉	希特勒
残疾人奥林匹克	帕拉林匹克
殘疾人奧林匹克	帕拉林匹克
残奥	帕運
殘奧	帕運
巴尔米拉环礁	帕邁拉環礁
帕劳	帛琉
希拉克	席哈克
账	賬
干着急	干著急
干着	幹著
畿內亞	幾內亞
几内亚比绍	幾內亞比索
幾內亞比紹	幾內亞比索
比利牛斯	庇里牛斯
库尔德人	庫德人
庫爾德人	庫德人
库尔德斯坦	庫德斯坦
庫爾德斯坦	庫德斯坦
庫爾德族	庫德斯坦
库尔德族	庫德族
康涅狄格	康乃狄克
约翰斯顿岛	強斯頓環礁
汇编	彙編
形而上学	形上學
形而上學	形上學
得克萨斯	德克薩斯
得克薩斯	德克薩斯
德累斯頓	德勒斯登
德累斯顿	德勒斯登
德里达	德希達
特拉华	德拉瓦
特拉華	德拉瓦
文翠珊	德蕾莎·梅伊
特蕾莎·梅	德蕾莎·梅伊
快闪存储器	快閃記憶體
闪存	快閃記憶體
情景喜剧	情境喜劇
處境喜劇	情境喜劇
想象	想像
愛德文	愛德溫
艾滋	愛滋
艾奧瓦	愛荷華
爱德华州	愛達荷州
应用程序	應用程式
懸樑	懸梁
懸臂樑	懸臂梁
戈尔巴乔夫	戈巴契夫
戈爾巴喬夫	戈巴契夫
戒烟	戒菸
戒煙	戒菸
戴克里先	戴克里先
打印度	打印度
扛大樑	扛大梁
披头士	披頭四
抽烟	抽菸
抽煙	抽菸
拒烟	拒菸
拒煙	拒菸
挑大樑	挑大梁
卷烟	捲菸
捲煙	捲菸
積架	捷豹
控件	控制項
推杆	推桿
第比利斯	提比里西
挥杆	揮桿
揮杆	揮桿
搜索引擎	搜尋引擎
莫士比港	摩斯比港
莫尔斯比港	摩斯比港
摩根士丹利	摩根史坦利
阿拉伯撒哈拉	撒拉威阿拉伯
台球	檯球
攻打	攻打
数字化	數位化
數碼化	數位化
数字技术	數位技術
數碼技術	數位技術
数字照相机	數位照相機
数码照相机	數位照相機
數碼照相機	數位照相機
数码相机	數位相機
數碼相機	數位相機
数字信号	數位訊號
數碼訊號	數位訊號
数字电视	數位電視
數碼電視	數位電視
数字音乐	數位音樂
數碼音樂	數位音樂
調制解調器	數據機
调制解调器	數據機
斯堪的納維亞	斯堪地那維亞
斯堪的纳维亚	斯堪地那維亞
斯洛文尼亚	斯洛維尼亞
斯洛文尼亞	斯洛維尼亞
新罕布什尔	新罕布夏
施罗德	施洛德
旱烟	旱菸
旱煙	旱菸
太阳微系统	昇陽電腦
太陽電腦	昇陽電腦
比勒陀利	普利托利
普利策	普利茲
普利策奖	普立茲獎
芯片	晶片
智能卡	智慧卡
智能手机	智慧型手機
智能手機	智慧型手機
智能电话	智慧型電話
智能電話	智慧型電話
智能机器人	智慧機器人
智能機械人	智慧機器人
知識產權	智慧財產權
知识产权	智慧財產權
萌島	曼島
马恩岛	曼島
木杆	木桿
木樑	木梁
尾班車	末班車
列奥纳多	李奧納多
杜塞尔多夫	杜塞道夫
杜塞爾多夫	杜塞道夫
迪拜	杜拜
汤加王国	東加王國
湯加王國	東加王國
东盟	東協
亚细安	東協
東盟	東協
东南亚国家联盟	東南亞國家協會
東南亞國家聯盟	東南亞國家協會
柏林墙	柏林圍牆
柏林牆	柏林圍牆
乍得	查德
查韦斯	查維茲
克林頓	柯林頓
克林顿	柯林頓
柱樑	柱梁
戴卓爾	柴契爾
撒切尔	柴契爾
格林納丁斯	格瑞那丁
格林纳丁斯	格瑞那丁
格林納達	格瑞那達
格林纳达	格瑞那達
桃金娘	桃金孃
台式电脑	桌上型電腦
乒乓	桌球
乒乓球	桌球
杆弟	桿弟
杆身	桿身
杆头	桿頭
杆頭	桿頭
樑上	梁上
樑柱	梁柱
梅尔·吉布森	梅爾·吉勃遜
梵高	梵谷
棟樑	棟梁
桑巴舞	森巴舞
榴莲	榴槤
榴蓮	榴槤
枪支	槍枝
标准杆	標準桿
標準杆	標準桿
毛里求斯	模里西斯
毛里裘斯	模里西斯
樸茨茅夫	樸茨茅斯
樹樑	樹梁
橋樑	橋梁
機械人	機器人
几率	機率
電單車	機車
橫樑	橫梁
枱	檯
字段	欄位
奥巴马	歐巴馬
奧巴馬	歐巴馬
正在叱咤	正在叱咤
圣佩德罗苏拉	汕埠
文莱	汶萊
沙律	沙拉
沙地阿拉伯	沙烏地阿拉伯
沙特阿拉伯	沙烏地阿拉伯
法属圭亚那	法屬蓋亞那
波斯尼亚	波士尼亞
波斯尼亞	波士尼亞
波斯尼亚和黑塞哥维那	波士尼亞與赫塞哥維納
波斯尼亞和黑塞哥維那	波士尼亞與赫塞哥維納
博茨瓦納	波札那
博茨瓦纳	波札那
波黑	波赫
洋烟	洋菸
洋煙	洋菸
帕特里克	派屈克
海洛英	海洛因
侯賽因	海珊
侯赛因	海珊
温得和克	溫荷克
溫得和克	溫荷克
鼠标	滑鼠
满杆	滿桿
汉诺威	漢諾瓦
漢诺威	漢諾瓦
泽连斯基	澤倫斯基
澤連斯基	澤倫斯基
乌冬面	烏冬麵
烤烟	烤菸
烤煙	烤菸
無樑樓蓋	無梁樓蓋
无烟日	無菸日
無煙日	無菸日
无烟环境	無菸環境
無煙環境	無菸環境
烟熏	煙燻
首席运营官	營運長
熏烤	燻烤
熏肉	燻肉
熏黑	燻黑
版权信息	版權資訊
疯牛病	狂牛症
瘋牛症	狂牛症
鐵托	狄托
铁托	狄托
塞拉利昂	獅子山
独联体	獨立國協
獨聯體	獨立國協
独立国家联合体	獨立國家國協
獨立國家聯合體	獨立國家國協
多民族玻利維亞國	玻利維亞多民族國
多民族玻利维亚国	玻利維亞多民族國
波利尼西亚	玻里尼西亞
波利尼西亞	玻里尼西亞
本傑明	班傑明
本杰明	班傑明
球杆	球桿
理查德	理察
卢塞恩	琉森
危地馬拉	瓜地馬拉
危地马拉	瓜地馬拉
巴伦西亚	瓦倫西亞
華倫西亞	瓦倫西亞
冈比亚	甘比亞
岡比亞	甘比亞
肯尼迪	甘迺迪
留尼汪	留尼旺
毕加索	畢卡索
综合征	綜合徵
徵狀	症狀
勃朗宁	白朗寧
百慕大	百慕達
卢旺达	盧安達
盧旺達	盧安達
真人騷	真人秀
睾	睪
知識產權局	知識產權局
知识产权局	知識產權局
知識產權署	知識產權署
知识产权署	知識產權署
石樑	石梁
硅	矽
硅藻	硅藻
硬盘	硬碟
硬件	硬體
盘片	碟片
磁盘	磁碟
磁道	磁軌
禁烟	禁菸
禁煙	禁菸
福尔马林	福馬林
福爾馬林	福馬林
私烟	私菸
私煙	私菸
程序员	程式設計師
编程语言	程式語言
空中客车	空中巴士
空气质量	空氣品質
空氣質素	空氣品質
突尼斯	突尼西亞
绑紧跳	笨豬跳
蹦极跳	笨豬跳
短信	簡訊
約翰內斯堡	約翰尼斯堡
约翰内斯堡	約翰尼斯堡
纽黑文	紐哈芬
新奥尔良	紐奧良
新奧爾良	紐奧良
新几内亚	紐幾內亞
新幾內亞	紐幾內亞
新西兰	紐西蘭
新西蘭	紐西蘭
紙煙	紙菸
纸烟	紙菸
索尔仁尼琴	索忍尼辛
索贊尼辛	索忍尼辛
所罗门群岛	索羅門群島
所羅門群島	索羅門群島
索馬里	索馬里
索马里	索馬里
索馬里蘭	索馬利蘭
索马里兰	索馬利蘭
維爾京群島	維京群島
维尔京群岛	維京群島
弗吉尼亚	維吉尼亞
佛得角	維德角
维特根斯坦	維根斯坦
網絡遊戲	網路遊戲
网络游戏	網路遊戲
互联网	網際網路
互联网络	網際網路
互聯網	網際網路
互聯網絡	網際網路
因特网	網際網路
繞樑	繞梁
系着	繫着
卢瓦尔	羅亞爾
盧瓦爾	羅亞爾
卢浮宫	羅浮宮
樂行童軍	羅浮童軍
意大利	義大利
意大利面	意大利麵
意裔	義裔
昂山素姬	翁山蘇姬
昂山素季	翁山蘇姬
圣基茨和尼维斯	聖克里斯多福及尼維斯
聖吉斯納域斯	聖克里斯多福及尼維斯
聖佐治	聖喬治
圣地亚哥	聖地牙哥
圣迭戈	聖地牙哥
厄尔尼诺	聖嬰
厄爾尼諾	聖嬰
圣文森特和格林纳丁斯	聖文森及格瑞那丁
聖文森特和格林納丁斯	聖文森及格瑞那丁
圣赫勒拿	聖赫倫那
圣卢西亚	聖露西亞
聖盧西亞	聖露西亞
圣马力诺	聖馬利諾
聖馬力諾	聖馬利諾
肯尼亚	肯亞
氨基酸	胺基酸
脊樑	脊梁
自由泳	自由式
三藩市	舊金山
艾森豪威尔	艾森豪
埃菲尔	艾菲爾
阿里埃勒·沙龍	艾里爾·夏隆
阿里埃勒·沙龙	艾里爾·夏隆
帕塔亚	芭達亞
黎克特制	黎克特制
里氏0	芮氏0
里氏1	芮氏1
里氏2	芮氏2
里氏3	芮氏3
里氏4	芮氏4
里氏5	芮氏5
里氏6	芮氏6
里氏7	芮氏7
里氏8	芮氏8
里氏9	芮氏9
里氏地震规模	芮氏地震規模
里氏规模	芮氏規模
里氏震级	芮氏規模
当且仅当	若且唯若
味美思	苦艾酒
毛里塔尼亚	茅利塔尼亞
毛里塔尼亞	茅利塔尼亞
霍尔木兹	荷姆茲
霍爾木茲	荷姆茲
霍尼亚拉	荷尼阿拉
霍尼亞拉	荷尼阿拉
荷里活廣場	荷里活廣場
荷里活道	荷里活道
莫桑比克	莫三比克
瓦文萨	華勒沙
華里沙	華勒沙
瓦格纳	華格納
烟具	菸具
煙具	菸具
烟品	菸品
煙品	菸品
烟嘴	菸嘴
煙嘴	菸嘴
烟卷	煙捲
煙捲	菸捲
烟斗	菸斗
煙斗	菸斗
烟民	菸民
煙民	菸民
烟灰	菸灰
煙灰	菸灰
烟瘾	菸癮
煙癮	菸癮
烟丝	菸絲
煙絲	菸絲
烟草	菸草
煙草	菸草
烟叶	菸葉
煙葉	菸葉
烟蒂	菸蒂
煙蒂	菸蒂
烟袋	菸袋
煙袋	菸袋
烟农	菸農
煙農	菸農
烟酒	菸酒
煙酒	菸酒
烟头	菸頭
煙頭	菸頭
烟鬼	菸鬼
煙鬼	菸鬼
烟碱	菸鹼
煙鹼	菸鹼
万历朝鲜战争	萬曆朝鮮戰爭
瓦努阿图	萬那杜
瓦努阿圖	萬那杜
叶利钦	葉爾欽
葉利欽	葉爾欽
埃里温	葉里溫
埃里溫	葉里溫
也門	葉門
也门	葉門
着	著
着眼于	著眼於
科摩罗	葛摩
科摩羅	葛摩
格林美獎	葛萊美獎
格莱美奖	葛萊美獎
黑山共和国	蒙特內哥羅共和國
黑山共和國	蒙特內哥羅共和國
蒙特利尔	蒙特婁
蒙特利爾	蒙特婁
普密蓬	蒲美蓬
布隆迪	蒲隆地
圭亚那	蓋亞那
基地组织	蓋達組織
阿爾蓋達組織	蓋達組織
肖斯塔科维奇	蕭士塔高維奇
蕭士達高維契	蕭士塔高維奇
肖邦	蕭邦
薛定谔	薛丁格
扎伊尔	薩伊
扎伊爾	薩伊
素檀	蘇丹
苏里南	蘇利南
蘇里南	蘇利南
浮罗交怡	蘭卡威
浮羅交怡	蘭卡威
劳拉	蘿拉
虚拟现实	虛擬實境
荧光	螢光
荧屏	螢屏
行人路权	行人路權
行人路權	行人路權
流動作業系統	行動作業系統
移动操作系统	行動作業系統
流動應用程式	行動應用程式
移动应用程序	行動應用程式
流動支付	行動支付
移动支付	行動支付
流動網絡	行動網路
移动网络	行動網路
流動互聯網	行動網際網路
移动互联网	行動網際網路
流動裝置	行動裝置
移动设备	行動裝置
流動電話	行動電話
移动电话	行動電話
冲着	衝着
埃塞俄比亚	衣索比亞
埃塞俄比亞	衣索比亞
克隆人	複製人
国际象棋	西洋棋
國際象棋	西洋棋
赫梯	西臺
分辨率	解析度
解像度	解析度
译码	解碼
触摸屏	觸控螢幕
出租车	計程車
约翰逊	詹森
诺曼底	諾曼第
瑙魯	諾魯
瑙鲁	諾魯
科特迪瓦	象牙海岸
碧咸	貝克漢
貝寧共和國	貝南共和國
贝宁共和国	貝南共和國
貝爾格萊德	貝爾格勒
贝尔格莱德	貝爾格勒
伯利兹	貝里斯
伯利茲	貝里斯
首席财务官	財務長
集装箱	貨櫃
数据库	資料庫
數據庫	資料庫
信息时代	資訊時代
信息论	資訊理論
乔布斯	賈伯斯
本·拉登	賓·拉登
宾西法尼亚	賓夕法尼亞
本拉登	賓拉登
利比里亚	賴比瑞亞
利比里亞	賴比瑞亞
莱索托	賴索托
萊索托	賴索托
塞浦路斯	賽普勒斯
赫丘勒·波洛	赫丘勒·白羅
赫鲁晓夫	赫魯雪夫
跳樑小丑	跳梁小丑
切尔诺贝利	車諾比
软驱	軟碟機
軟件	軟體
软件	軟體
津巴布韋	辛巴威
津巴布韦	辛巴威
德特里克堡	迪特里克堡
径入	逕入
径到	逕到
径取	逕取
径启	逕啟
径寄	逕寄
径庭	逕庭
径往	逕往
径自	逕自
径行	逕行
径迎	逕迎
链接	連結
連結他	連結他
进制	進制
道琼斯	道瓊
道瓊斯	道瓊
达·芬奇	達·文西
达芬奇	達文西
溫納圖萬	那杜
丘吉尔	邱吉爾
多普勒	都卜勒
酰	醯
里士满	里奇蒙
金沙萨	金夏沙
金沙薩	金夏沙
健力士世界紀錄	金氏世界紀錄
健力士世界纪录	金氏世界紀錄
吉尼斯世界纪录	金氏世界紀錄
钚	鈈
鈎	鉤
钩	鈎
锎	鐦
锫	錇
镅	鎇
鋼樑	鋼梁
镎	鎿
钫	鈁
炼金	鍊金
锻炼	鍛鍊
锝	鍀
鐵杆	鐵桿
铁杆	鐵桿
泰坦尼克号	鐵達尼號
锿	鎄
关系着	關係著
写保护	防寫
阿布扎比	阿布達比
阿拉伯联合酋长国	阿拉伯聯合大公國
阿拉伯聯合酋長國	阿拉伯聯合大公國
亚拉巴马	阿拉巴馬
阿联酋	阿聯
阿聯酋	阿聯
亚的斯亚贝巴	阿迪斯阿貝巴
亞的斯亞貝巴	阿迪斯阿貝巴
罗纳德·里根	隆納·雷根
私隱	隱私
耶加達	雅加達
雅尔塔	雅爾達
雅爾塔	雅爾達
雅穆苏克雷	雅穆索戈
雅穆蘇克雷	雅穆索戈
雕樑畫棟	雕梁畫棟
悉尼	雪梨
雪茄烟	雪茄菸
雪茄煙	雪茄菸
莱特湾	雷伊泰灣
萊特灣	雷伊泰灣
激光	雷射
雷诺阿	雷諾瓦
电子烟	電子菸
電子煙	電子菸
晶体管	電晶體
晶體管	電晶體
电杆	電桿
电线杆	電線桿
电脑程序	電腦程式
计算机程序	電腦程式
电脑网络	電腦網路
電腦網絡	電腦網路
荷尔斯泰因	霍爾斯坦
荷爾斯泰因	霍爾斯坦
面包着	面包著
朝鲜战争	韓戰
声卡	音效卡
缺省	預設
导弹	飛彈
糊口	餬口
香烟	香菸
香煙	香菸
馬里共和國	馬利共和國
马里共和国	馬利共和國
馬拉維	馬拉威
马拉维	馬拉威
馬勒當拿	馬拉度納
马拉多纳	馬拉度納
馬斯特里赫特	馬斯垂克
马斯特里赫特	馬斯垂克
马耳他	馬爾他
馬爾代夫	馬爾地夫
马尔代夫	馬爾地夫
高清化	高畫質化
高清电视	高畫質電視
高清電視	高畫質電視
斗着	鬥著
魯賓斯·巴里切羅	魯本·巴瑞切羅
迈克尔	麥可
麦克尔	麥可
迈凯轮	麥拿輪
邁凱輪	麥拿輪
马萨诸塞	麻薩諸塞
粘膜	黏膜
戴安娜	黛安娜
狄安娜	黛安娜
点烟	點菸
點煙	點菸
霉素	黴素
鼻樑	鼻梁
㐷	傌
㐹	㑶
㐽	偑
㑇	㑳
㑈	倲
㑔	㑯
㑩	儸
㓥	劏
㔉	劚
㖊	噚
㖞	喎
㘎	㘚
㚯	㜄
㛀	媰
㛟	𡞵
㛠	𡢃
㛣	㜏
㛤	孋
㛿	𡠹
㟆	㠏
㟜	𡾱
㟥	嵾
㡎	幓
㤖	懧
㤘	㥮
㤭	憍
㤽	懤
㥪	慺
㦈	𢣏
㧏	掆
㧐	㩳
㧑	撝
㧛	擥
㧟	擓
㧰	擽
㨫	㩜
㭎	棡
㭏	椲
㭣	𣙎
㭤	樢
㭴	樫
㮠	𣞁
㱩	殰
㱮	殨
㲿	瀇
㳔	濧
㳠	澾
㳡	濄
㳢	𣾷
㳽	瀰
㴋	潚
㶉	鸂
㶶	燶
㶽	煱
㺍	獱
㻅	璯
㻏	𤫩
㻘	𤪺
㾡	𤷽
䀥	䁻
䁖	瞜
䂵	碽
䃅	磾
䅉	稏
䅟	穇
䅪	𥢢
䇚	𥵜
䇲	筴
䉤	籔
䌶	䊷
䌷	紬
䌸	縳
䌹	絅
䌺	䋙
䌻	䋚
䌼	綐
䌽	綵
䌾	䋻
䌿	䋹
䍀	繿
䍁	繸
䎬	䎱
䏝	膞
䓓	薵
䓖	藭
䖼	𧍕
䗖	螮
䘛	𧝞
䘞	𧜗
䙊	𧜵
䙌	䙡
䙓	襬
䛓	譼
䜣	訢
䜤	鿁
䜥	𧩙
䜧	䜀
䜩	讌
䝙	貙
䞌	𧵳
䞍	䝼
䞎	𧶧
䞐	賰
䟢	躎
䢀	𨊰
䢁	𨊸
䢂	𨋢
䥺	釾
䥽	鏺
䥾	䥱
䥿	𨯅
䦀	𨦫
䦁	𨧜
䦂	䥇
䦃	鐯
䦅	鐥
䦆	钁
䦶	䦛
䦷	䦟
䩄	靦
䭪	𩞯
䯃	𩣑
䯄	騧
䯅	䯀
䲝	䱽
䲞	𩶘
䲟	鮣
䲠	鰆
䲡	鰌
䲢	鰧
䲣	䱷
䲤	鿐
䴓	鳾
䴔	鵁
䴕	鴷
䴖	鶄
䴗	鶪
䴘	鷈
䴙	鷿
䶮	龑
万	萬
与	與
专	專
业	業
丛	叢
东	東
丝	絲
丢	丟
两	兩
严	嚴
丧	喪
个	個
丰	豐
临	臨
为	為
丽	麗
举	舉
么	麼
义	義
乌	烏
乐	樂
乔	喬
习	習
乡	鄉
书	書
买	買
乱	亂
争	爭
于	於
亏	虧
云	雲
亚	亞
产	產
亩	畝
亲	親
亵	褻
亸	嚲
亿	億
仅	僅
从	從
仑	侖
仓	倉
仪	儀
们	們
价	價
众	眾
优	優
会	會
伛	傴
伞	傘
伟	偉
传	傳
伡	俥
伣	俔
伤	傷
伥	倀
伦	倫
伧	傖
伪	偽
伫	佇
体	體
佣	傭
佥	僉
侠	俠
侣	侶
侥	僥
侦	偵
侧	側
侨	僑
侩	儈
侪	儕
侬	儂
俣	俁
俦	儔
俨	儼
俩	倆
俪	儷
俫	倈
俭	儉
债	債
倾	傾
偬	傯
偻	僂
偾	僨
偿	償
傥	儻
傧	儐
储	儲
傩	儺
儿	兒
兑	兌
兖	兗
党	黨
兰	蘭
关	關
兴	興
兹	茲
养	養
兽	獸
冁	囅
内	內
冈	岡
册	冊
写	寫
军	軍
农	農
冯	馮
冲	沖
决	決
况	況
冻	凍
净	淨
凄	淒
凉	涼
减	減
凑	湊
凛	凜
几	幾
凤	鳳
凫	鳧
凭	憑
凯	凱
击	擊
凿	鑿
刍	芻
划	劃
刘	劉
则	則
刚	剛
创	創
删	刪
别	別
刬	剗
刭	剄
刹	剎
刽	劊
刾	㓨
刿	劌
剀	剴
剂	劑
剐	剮
剑	劍
剥	剝
剧	劇
劝	勸
办	辦
务	務
劢	勱
动	動
励	勵
劲	勁
劳	勞
势	勢
勋	勛
勚	勩
匀	勻
匦	匭
匮	匱
区	區
医	醫
华	華
协	協
单	單
卖	賣
卢	盧
卤	鹵
卧	臥
卫	衛
却	卻
厂	廠
厅	廳
历	歷
厉	厲
压	壓
厌	厭
厍	厙
厐	龎
厕	廁
厢	廂
厣	厴
厦	廈
厨	廚
厩	廄
厮	廝
县	縣
叁	叄
参	參
叆	靉
叇	靆
双	雙
发	發
变	變
叙	敘
叠	疊
叶	葉
号	號
叹	嘆
叽	嘰
后	後
吓	嚇
吕	呂
吗	嗎
吣	唚
吨	噸
听	聽
启	啟
吴	吳
呐	吶
呒	嘸
呓	囈
呕	嘔
呖	嚦
呗	唄
员	員
呙	咼
呛	嗆
呜	嗚
咏	詠
咙	嚨
咛	嚀
咝	噝
响	響
哑	啞
哒	噠
哓	嘵
哔	嗶
哕	噦
哗	嘩
哙	噲
哜	嚌
哝	噥
哟	喲
唛	嘜
唝	嗊
唠	嘮
唡	啢
唢	嗩
唤	喚
啧	嘖
啬	嗇
啭	囀
啮	齧
啯	嘓
啰	囉
啴	嘽
啸	嘯
喂	餵
喷	噴
喽	嘍
喾	嚳
嗫	囁
嗳	噯
嘘	噓
嘤	嚶
嘱	囑
噜	嚕
嚣	囂
团	團
园	園
囱	囪
围	圍
囵	圇
国	國
图	圖
圆	圓
圣	聖
圹	壙
场	場
坏	壞
块	塊
坚	堅
坛	壇
坜	壢
坝	壩
坞	塢
坟	墳
坠	墜
垄	壟
垅	壠
垆	壚
垒	壘
垦	墾
垩	堊
垫	墊
垭	埡
垯	墶
垱	壋
垲	塏
埘	塒
埙	塤
埚	堝
堑	塹
堕	墮
塆	壪
墙	牆
壮	壯
声	聲
壳	殼
壶	壺
壸	壼
处	處
备	備
复	復
够	夠
头	頭
夹	夾
夺	奪
奁	奩
奂	奐
奋	奮
奖	獎
奥	奧
妆	妝
妇	婦
妈	媽
妩	嫵
妪	嫗
妫	媯
姗	姍
姹	奼
娄	婁
娅	婭
娆	嬈
娇	嬌
娈	孌
娱	娛
娲	媧
娴	嫻
婳	嫿
婴	嬰
婵	嬋
婶	嬸
媪	媼
媭	嬃
嫒	嬡
嫔	嬪
嫱	嬙
嬷	嬤
孙	孫
学	學
孪	孿
宁	寧
宝	寶
实	實
宠	寵
审	審
宪	憲
宫	宮
宽	寬
宾	賓
寝	寢
对	對
寻	尋
导	導
寿	壽
将	將
尔	爾
尘	塵
尝	嘗
尧	堯
尴	尷
尸	屍
尽	盡
层	層
屃	屓
屉	屜
届	屆
属	屬
屡	屢
屦	屨
屿	嶼
岁	歲
岂	豈
岖	嶇
岗	崗
岘	峴
岚	嵐
岛	島
岭	嶺
岽	崬
岿	巋
峃	嶨
峄	嶧
峡	峽
峣	嶢
峤	嶠
峥	崢
峦	巒
崂	嶗
崃	崍
崄	嶮
崭	嶄
嵘	嶸
嵚	嶔
嵝	嶁
巅	巔
巩	鞏
巯	巰
币	幣
帅	帥
师	師
帏	幃
帐	帳
帘	簾
帜	幟
带	帶
帧	幀
帮	幫
帱	幬
帻	幘
帼	幗
幂	冪
并	並
广	廣
庄	莊
庆	慶
庐	廬
庑	廡
库	庫
应	應
庙	廟
庞	龐
废	廢
庼	廎
廪	廩
开	開
异	異
弃	棄
弑	弒
张	張
弥	彌
弪	弳
弯	彎
弹	彈
强	強
归	歸
当	當
录	錄
彟	彠
彦	彥
彨	彲
彻	徹
径	徑
徕	徠
忆	憶
忏	懺
忧	憂
忾	愾
怀	懷
态	態
怂	慫
怃	憮
怄	慪
怅	悵
怆	愴
怜	憐
总	總
怼	懟
怿	懌
恋	戀
恒	恆
恳	懇
恶	惡
恸	慟
恹	懨
恺	愷
恻	惻
恼	惱
恽	惲
悦	悅
悫	愨
悬	懸
悭	慳
悮	悞
悯	憫
惊	驚
惧	懼
惨	慘
惩	懲
惫	憊
惬	愜
惭	慚
惮	憚
惯	慣
愠	慍
愤	憤
愦	憒
愿	願
慑	懾
慭	憖
懑	懣
懒	懶
懔	懍
戆	戇
戋	戔
戏	戲
戗	戧
战	戰
戬	戩
戯	戱
户	戶
扑	撲
执	執
扩	擴
扪	捫
扫	掃
扬	揚
扰	擾
抚	撫
抛	拋
抟	摶
抠	摳
抡	掄
抢	搶
护	護
报	報
担	擔
拟	擬
拢	攏
拣	揀
拥	擁
拦	攔
拧	擰
拨	撥
择	擇
挂	掛
挚	摯
挛	攣
挜	掗
挝	撾
挞	撻
挟	挾
挠	撓
挡	擋
挢	撟
挣	掙
挤	擠
挥	揮
挦	撏
捝	挩
捞	撈
损	損
捡	撿
换	換
捣	搗
据	據
掳	擄
掴	摑
掷	擲
掸	撣
掺	摻
掼	摜
揽	攬
揾	搵
揿	撳
搀	攙
搁	擱
搂	摟
搅	攪
携	攜
摄	攝
摅	攄
摆	擺
摇	搖
摈	擯
摊	攤
撄	攖
撑	撐
撵	攆
撷	擷
撸	擼
撺	攛
擜	㩵
擞	擻
攒	攢
敌	敵
敛	斂
敩	斆
数	數
斋	齋
斓	斕
斩	斬
断	斷
无	無
旧	舊
时	時
旷	曠
旸	暘
昙	曇
昼	晝
昽	曨
显	顯
晋	晉
晒	曬
晓	曉
晔	曄
晕	暈
晖	暉
暂	暫
暧	曖
术	術
机	機
杀	殺
杂	雜
权	權
杠	槓
条	條
来	來
杨	楊
杩	榪
杰	傑
极	極
构	構
枞	樅
枢	樞
枣	棗
枥	櫪
枧	梘
枨	棖
枪	槍
枫	楓
枭	梟
柜	櫃
柠	檸
柽	檉
栀	梔
栅	柵
标	標
栈	棧
栉	櫛
栊	櫳
栋	棟
栌	櫨
栎	櫟
栏	欄
树	樹
栖	棲
样	樣
栾	欒
桠	椏
桡	橈
桢	楨
档	檔
桤	榿
桥	橋
桦	樺
桧	檜
桨	槳
桩	樁
桪	樳
梦	夢
梼	檮
梾	棶
梿	槤
检	檢
棁	梲
棂	欞
椁	槨
椝	槼
椟	櫝
椠	槧
椢	槶
椤	欏
椫	樿
椭	橢
椮	槮
楼	樓
榄	欖
榅	榲
榇	櫬
榈	櫚
榉	櫸
槚	檟
槛	檻
槟	檳
槠	櫧
横	橫
樯	檣
樱	櫻
橥	櫫
橱	櫥
橹	櫓
橼	櫞
檩	檁
欢	歡
欤	歟
欧	歐
歼	殲
殁	歿
殇	殤
残	殘
殒	殞
殓	殮
殚	殫
殡	殯
殴	毆
毁	毀
毂	轂
毕	畢
毙	斃
毡	氈
毵	毿
毶	𣯶
氇	氌
气	氣
氢	氫
氩	氬
氲	氳
汇	匯
汉	漢
汤	湯
汹	洶
沟	溝
没	沒
沣	灃
沤	漚
沥	瀝
沦	淪
沧	滄
沨	渢
沩	溈
沪	滬
泞	濘
泪	淚
泶	澩
泷	瀧
泸	瀘
泺	濼
泻	瀉
泼	潑
泽	澤
泾	涇
洁	潔
洒	灑
洼	窪
浃	浹
浅	淺
浆	漿
浇	澆
浈	湞
浉	溮
浊	濁
测	測
浍	澮
济	濟
浏	瀏
浐	滻
浑	渾
浒	滸
浓	濃
浔	潯
浕	濜
涂	塗
涛	濤
涝	澇
涞	淶
涟	漣
涠	潿
涡	渦
涢	溳
涣	渙
涤	滌
润	潤
涧	澗
涨	漲
涩	澀
渊	淵
渌	淥
渍	漬
渎	瀆
渐	漸
渑	澠
渔	漁
渖	瀋
渗	滲
温	溫
湾	灣
湿	濕
溁	濚
溃	潰
溅	濺
溆	漵
溇	漊
滗	潷
滚	滾
滞	滯
滟	灩
滠	灄
满	滿
滢	瀅
滤	濾
滥	濫
滦	灤
滨	濱
滩	灘
滪	澦
漤	灠
潆	瀠
潇	瀟
潋	瀲
潍	濰
潜	潛
潴	瀦
澛	瀂
澜	瀾
濑	瀨
濒	瀕
灏	灝
灭	滅
灯	燈
灵	靈
灾	災
灿	燦
炀	煬
炉	爐
炖	燉
炜	煒
炝	熗
点	點
炼	煉
炽	熾
烁	爍
烂	爛
烃	烴
烛	燭
烟	煙
烦	煩
烧	燒
烨	燁
烩	燴
烫	燙
烬	燼
热	熱
焕	煥
焖	燜
焘	燾
煴	熅
爱	愛
爷	爺
牍	牘
牦	氂
牵	牽
牺	犧
犊	犢
状	狀
犷	獷
犸	獁
犹	猶
狈	狽
狝	獮
狞	獰
独	獨
狭	狹
狮	獅
狯	獪
狰	猙
狱	獄
狲	猻
猃	獫
猎	獵
猕	獼
猡	玀
猪	豬
猫	貓
猬	蝟
献	獻
獭	獺
玑	璣
玙	璵
玚	瑒
玛	瑪
玮	瑋
环	環
现	現
玱	瑲
玺	璽
珐	琺
珑	瓏
珰	璫
珲	琿
琎	璡
琏	璉
琐	瑣
琼	瓊
瑶	瑤
瑷	璦
瑸	璸
璎	瓔
瓒	瓚
瓯	甌
电	電
画	畫
畅	暢
畴	疇
疖	癤
疗	療
疟	瘧
疠	癘
疡	瘍
疬	癧
疭	瘲
疮	瘡
疯	瘋
痈	癰
痉	痙
痒	癢
痖	瘂
痨	癆
痪	瘓
痫	癇
痳	痲
瘅	癉
瘆	瘮
瘗	瘞
瘘	瘺
瘪	癟
瘫	癱
瘾	癮
瘿	癭
癞	癩
癣	癬
癫	癲
皑	皚
皱	皺
皲	皸
盏	盞
盐	鹽
监	監
盖	蓋
盗	盜
盘	盤
眍	瞘
眦	眥
眬	矓
睁	睜
睐	睞
睑	瞼
瞆	瞶
瞒	瞞
瞩	矚
矫	矯
矶	磯
矾	礬
矿	礦
砀	碭
码	碼
砖	磚
砗	硨
砚	硯
砜	碸
砺	礪
砻	礱
砾	礫
础	礎
硁	硜
硕	碩
硖	硤
硗	磽
硙	磑
硚	礄
确	確
硵	磠
硷	鹼
碍	礙
碛	磧
碜	磣
碱	鹼
礼	禮
祃	禡
祎	禕
祢	禰
祯	禎
祷	禱
祸	禍
禀	稟
禄	祿
禅	禪
离	離
秃	禿
秆	稈
种	種
积	積
称	稱
秽	穢
秾	穠
稆	穭
税	稅
稣	穌
稳	穩
穑	穡
穷	窮
窃	竊
窍	竅
窎	窵
窑	窯
窜	竄
窝	窩
窥	窺
窦	竇
窭	窶
竖	豎
竞	競
笃	篤
笋	筍
笔	筆
笕	筧
笺	箋
笼	籠
笾	籩
筑	築
筚	篳
筛	篩
筜	簹
筝	箏
筹	籌
筼	篔
签	簽
简	簡
箓	籙
箦	簀
箧	篋
箨	籜
箩	籮
箪	簞
箫	簫
篑	簣
篓	簍
篮	籃
篯	籛
篱	籬
簖	籪
籁	籟
籴	糴
类	類
籼	秈
粜	糶
粝	糲
粤	粵
粪	糞
粮	糧
糁	糝
糇	餱
紧	緊
絷	縶
纟	糹
纠	糾
纡	紆
红	紅
纣	紂
纤	纖
纥	紇
约	約
级	級
纨	紈
纩	纊
纪	紀
纫	紉
纬	緯
纭	紜
纮	紘
纯	純
纰	紕
纱	紗
纲	綱
纳	納
纴	紝
纵	縱
纶	綸
纷	紛
纸	紙
纹	紋
纺	紡
纻	紵
纼	紖
纽	紐
纾	紓
线	線
绀	紺
绁	紲
绂	紱
练	練
组	組
绅	紳
细	細
织	織
终	終
绉	縐
绊	絆
绋	紼
绌	絀
绍	紹
绎	繹
经	經
绐	紿
绑	綁
绒	絨
结	結
绔	絝
绕	繞
绖	絰
绗	絎
绘	繪
给	給
绚	絢
绛	絳
络	絡
绝	絕
绞	絞
统	統
绠	綆
绡	綃
绢	絹
绣	繡
绤	綌
绥	綏
绦	絛
继	繼
绨	綈
绩	績
绪	緒
绫	綾
绬	緓
续	續
绮	綺
绯	緋
绰	綽
绱	鞝
绲	緄
绳	繩
维	維
绵	綿
绶	綬
绷	繃
绸	綢
绹	綯
绺	綹
绻	綣
综	綜
绽	綻
绾	綰
绿	綠
缀	綴
缁	緇
缂	緙
缃	緗
缄	緘
缅	緬
缆	纜
缇	緹
缈	緲
缉	緝
缊	縕
缋	繢
缌	緦
缍	綞
缎	緞
缏	緶
缐	線
缑	緱
缒	縋
缓	緩
缔	締
缕	縷
编	編
缗	緡
缘	緣
缙	縉
缚	縛
缛	縟
缜	縝
缝	縫
缞	縗
缟	縞
缠	纏
缡	縭
缢	縊
缣	縑
缤	繽
缥	縹
缦	縵
缧	縲
缨	纓
缩	縮
缪	繆
缫	繅
缬	纈
缭	繚
缮	繕
缯	繒
缰	韁
缱	繾
缲	繰
缳	繯
缴	繳
缵	纘
罂	罌
网	網
罗	羅
罚	罰
罢	罷
罴	羆
羁	羈
羟	羥
羡	羨
翘	翹
翙	翽
翚	翬
耢	耮
耧	耬
耸	聳
耻	恥
聂	聶
聋	聾
职	職
聍	聹
联	聯
聩	聵
聪	聰
肃	肅
肠	腸
肤	膚
肮	骯
肾	腎
肿	腫
胀	脹
胁	脅
胆	膽
胜	勝
胧	朧
胨	腖
胪	臚
胫	脛
胶	膠
脉	脈
脍	膾
脏	髒
脐	臍
脑	腦
脓	膿
脔	臠
脚	腳
脱	脫
脶	腡
脸	臉
腊	臘
腌	醃
腘	膕
腭	齶
腻	膩
腼	靦
腽	膃
腾	騰
膑	臏
臜	臢
舆	輿
舣	艤
舰	艦
舱	艙
舻	艫
艰	艱
艳	艷
艺	藝
节	節
芈	羋
芗	薌
芜	蕪
芦	蘆
苁	蓯
苇	葦
苈	藶
苋	莧
苌	萇
苍	蒼
苎	苧
苏	蘇
苧	薴
茎	莖
茏	蘢
茑	蔦
茔	塋
茕	煢
茧	繭
荆	荊
荐	薦
荙	薘
荚	莢
荛	蕘
荜	蓽
荝	萴
荞	蕎
荟	薈
荠	薺
荡	盪
荣	榮
荤	葷
荥	滎
荦	犖
荧	熒
荨	蕁
荩	藎
荪	蓀
荫	蔭
荬	蕒
荭	葒
荮	葤
药	藥
莅	蒞
莱	萊
莲	蓮
莳	蒔
莴	萵
莶	薟
获	獲
莸	蕕
莹	瑩
莺	鶯
莼	蓴
萚	蘀
萝	蘿
萤	螢
营	營
萦	縈
萧	蕭
萨	薩
葱	蔥
蒇	蕆
蒉	蕢
蒋	蔣
蒌	蔞
蓝	藍
蓟	薊
蓠	蘺
蓣	蕷
蓥	鎣
蓦	驀
蔂	虆
蔷	薔
蔹	蘞
蔺	藺
蔼	藹
蕰	薀
蕲	蘄
蕴	蘊
薮	藪
藓	蘚
蘖	櫱
虏	虜
虑	慮
虚	虛
虫	蟲
虮	蟣
虽	雖
虾	蝦
虿	蠆
蚀	蝕
蚁	蟻
蚂	螞
蚃	蠁
蚕	蠶
蚬	蜆
蛊	蠱
蛎	蠣
蛏	蟶
蛮	蠻
蛰	蟄
蛱	蛺
蛲	蟯
蛳	螄
蛴	蠐
蜕	蛻
蜗	蝸
蜡	蠟
蝇	蠅
蝈	蟈
蝉	蟬
蝎	蠍
蝼	螻
蝾	蠑
螀	螿
螨	蟎
蟏	蠨
衅	釁
衔	銜
补	補
衬	襯
衮	袞
袄	襖
袅	裊
袆	褘
袜	襪
袭	襲
袯	襏
装	裝
裆	襠
裈	褌
裢	褳
裣	襝
裤	褲
裥	襉
褛	褸
褴	襤
襕	襴
见	見
观	觀
觃	覎
规	規
觅	覓
视	視
觇	覘
览	覽
觉	覺
觊	覬
觋	覡
觌	覿
觍	覥
觎	覦
觏	覯
觐	覲
觑	覷
觞	觴
触	觸
觯	觶
訚	誾
詟	讋
誉	譽
誊	謄
讠	訁
计	計
订	訂
讣	訃
认	認
讥	譏
讦	訐
讧	訌
讨	討
让	讓
讪	訕
讫	訖
讬	託
训	訓
议	議
讯	訊
记	記
讱	訒
讲	講
讳	諱
讴	謳
讵	詎
讶	訝
讷	訥
许	許
讹	訛
论	論
讻	訩
讼	訟
讽	諷
设	設
访	訪
诀	訣
证	證
诂	詁
诃	訶
评	評
诅	詛
识	識
诇	詗
诈	詐
诉	訴
诊	診
诋	詆
诌	謅
词	詞
诎	詘
诏	詔
诐	詖
译	譯
诒	詒
诓	誆
诔	誄
试	試
诖	詿
诗	詩
诘	詰
诙	詼
诚	誠
诛	誅
诜	詵
话	話
诞	誕
诟	詬
诠	詮
诡	詭
询	詢
诣	詣
诤	諍
该	該
详	詳
诧	詫
诨	諢
诩	詡
诪	譸
诫	誡
诬	誣
语	語
诮	誚
误	誤
诰	誥
诱	誘
诲	誨
诳	誑
说	說
诵	誦
诶	誒
请	請
诸	諸
诹	諏
诺	諾
读	讀
诼	諑
诽	誹
课	課
诿	諉
谀	諛
谁	誰
谂	諗
调	調
谄	諂
谅	諒
谆	諄
谇	誶
谈	談
谊	誼
谋	謀
谌	諶
谍	諜
谎	謊
谏	諫
谐	諧
谑	謔
谒	謁
谓	謂
谔	諤
谕	諭
谖	諼
谗	讒
谘	諮
谙	諳
谚	諺
谛	諦
谜	謎
谝	諞
谞	諝
谟	謨
谠	讜
谡	謖
谢	謝
谣	謠
谤	謗
谥	諡
谦	謙
谧	謐
谨	謹
谩	謾
谪	謫
谫	譾
谬	謬
谭	譚
谮	譖
谯	譙
谰	讕
谱	譜
谲	譎
谳	讞
谴	譴
谵	譫
谶	讖
豮	豶
贝	貝
贞	貞
负	負
贠	貟
贡	貢
财	財
责	責
贤	賢
败	敗
货	貨
质	質
贩	販
贪	貪
贫	貧
贬	貶
购	購
贮	貯
贯	貫
贰	貳
贱	賤
贲	賁
贳	貰
贴	貼
贵	貴
贶	貺
贷	貸
贸	貿
费	費
贺	賀
贻	貽
贼	賊
贽	贄
贾	賈
贿	賄
赀	貲
赁	賃
赂	賂
赃	贓
资	資
赅	賅
赆	贐
赇	賕
赈	賑
赉	賚
赊	賒
赋	賦
赌	賭
赍	齎
赎	贖
赏	賞
赐	賜
赑	贔
赒	賙
赓	賡
赔	賠
赕	賧
赖	賴
赗	賵
赘	贅
赙	賻
赚	賺
赛	賽
赜	賾
赝	贗
赞	贊
赟	贇
赠	贈
赡	贍
赢	贏
赣	贛
赪	赬
赵	趙
赶	趕
趋	趨
趱	趲
趸	躉
跃	躍
跄	蹌
跞	躒
践	踐
跶	躂
跷	蹺
跸	蹕
跹	躚
跻	躋
踊	踴
踌	躊
踪	蹤
踬	躓
踯	躑
蹑	躡
蹒	蹣
蹰	躕
蹿	躥
躏	躪
躜	躦
躯	軀
车	車
轧	軋
轨	軌
轩	軒
轪	軑
轫	軔
转	轉
轭	軛
轮	輪
软	軟
轰	轟
轱	軲
轲	軻
轳	轤
轴	軸
轵	軹
轶	軼
轷	軤
轸	軫
轹	轢
轺	軺
轻	輕
轼	軾
载	載
轾	輊
轿	轎
辀	輈
辁	輇
辂	輅
较	較
辄	輒
辅	輔
辆	輛
辇	輦
辈	輩
辉	輝
辊	輥
辋	輞
辌	輬
辍	輟
辎	輜
辏	輳
辐	輻
辑	輯
辒	轀
输	輸
辔	轡
辕	轅
辖	轄
辗	輾
辘	轆
辙	轍
辚	轔
辞	辭
辩	辯
辫	辮
边	邊
辽	遼
达	達
迁	遷
过	過
迈	邁
运	運
还	還
这	這
进	進
远	遠
违	違
连	連
迟	遲
迩	邇
迳	逕
迹	跡
适	適
选	選
逊	遜
递	遞
逦	邐
逻	邏
遗	遺
遥	遙
邓	鄧
邝	鄺
邬	鄔
邮	郵
邹	鄒
邺	鄴
邻	鄰
郏	郟
郐	鄶
郑	鄭
郓	鄆
郦	酈
郧	鄖
郸	鄲
酂	酇
酝	醞
酦	醱
酱	醬
酽	釅
酾	釃
酿	釀
释	釋
鉴	鑒
銮	鑾
錾	鏨
钅	釒
钆	釓
钇	釔
针	針
钉	釘
钊	釗
钋	釙
钌	釕
钍	釷
钎	釺
钏	釧
钐	釤
钑	鈒
钒	釩
钓	釣
钔	鍆
钕	釹
钖	鍚
钗	釵
钘	鈃
钙	鈣
钛	鈦
钜	鉅
钝	鈍
钞	鈔
钟	鍾
钠	鈉
钡	鋇
钢	鋼
钣	鈑
钤	鈐
钥	鑰
钦	欽
钧	鈞
钨	鎢
钪	鈧
钬	鈥
钭	鈄
钮	鈕
钯	鈀
钰	鈺
钱	錢
钲	鉦
钳	鉗
钴	鈷
钵	缽
钶	鈳
钷	鉕
钸	鈽
钹	鈸
钺	鉞
钻	鑽
钼	鉬
钽	鉭
钾	鉀
钿	鈿
铀	鈾
铁	鐵
铂	鉑
铃	鈴
铄	鑠
铅	鉛
铆	鉚
铇	鉋
铈	鈰
铉	鉉
铊	鉈
铋	鉍
铌	鈮
铍	鈹
铎	鐸
铏	鉶
铐	銬
铑	銠
铒	鉺
铓	鋩
铔	錏
铕	銪
铖	鋮
铗	鋏
铘	鋣
铙	鐃
铚	銍
铛	鐺
铜	銅
铝	鋁
铞	銱
铟	銦
铠	鎧
铡	鍘
铢	銖
铣	銑
铤	鋌
铥	銩
铦	銛
铧	鏵
铨	銓
铩	鎩
铪	鉿
铫	銚
铬	鉻
铭	銘
铮	錚
铯	銫
铰	鉸
铱	銥
铲	鏟
铳	銃
铴	鐋
铵	銨
银	銀
铷	銣
铸	鑄
铹	鐒
铺	鋪
铻	鋙
铼	錸
铽	鋱
链	鏈
铿	鏗
销	銷
锁	鎖
锂	鋰
锃	鋥
锄	鋤
锅	鍋
锆	鋯
锇	鋨
锈	鏽
锉	銼
锊	鋝
锋	鋒
锌	鋅
锍	鋶
锏	鐧
锐	銳
锑	銻
锒	鋃
锓	鋟
锔	鋦
锕	錒
锖	錆
锗	鍺
锘	鍩
错	錯
锚	錨
锛	錛
锜	錡
锞	錁
锟	錕
锠	錩
锡	錫
锢	錮
锣	鑼
锤	錘
锥	錐
锦	錦
锧	鑕
锨	杴
锩	錈
锪	鍃
锬	錟
锭	錠
键	鍵
锯	鋸
锰	錳
锱	錙
锲	鍥
锳	鍈
锴	鍇
锵	鏘
锶	鍶
锷	鍔
锸	鍤
锹	鍬
锺	鍾
锻	鍛
锼	鎪
锽	鍠
锾	鍰
镀	鍍
镁	鎂
镂	鏤
镃	鎡
镄	鐨
镆	鏌
镇	鎮
镈	鎛
镉	鎘
镊	鑷
镋	钂
镌	鐫
镍	鎳
镏	鎦
镐	鎬
镑	鎊
镒	鎰
镓	鎵
镔	鑌
镕	鎔
镖	鏢
镗	鏜
镘	鏝
镙	鏍
镚	鏰
镛	鏞
镜	鏡
镝	鏑
镞	鏃
镟	鏇
镠	鏐
镡	鐔
镢	钁
镣	鐐
镤	鏷
镥	鑥
镦	鐓
镧	鑭
镨	鐠
镩	鑹
镪	鏹
镫	鐙
镬	鑊
镭	鐳
镮	鐶
镯	鐲
镰	鐮
镱	鐿
镲	鑔
镳	鑣
镴	鑞
镵	鑱
镶	鑲
长	長
门	門
闩	閂
闪	閃
闫	閆
闬	閈
闭	閉
问	問
闯	闖
闰	閏
闱	闈
闲	閒
闳	閎
间	間
闵	閔
闶	閌
闷	悶
闸	閘
闹	鬧
闺	閨
闻	聞
闼	闥
闽	閩
闾	閭
闿	闓
阀	閥
阁	閣
阂	閡
阃	閫
阄	鬮
阅	閱
阆	閬
阇	闍
阈	閾
阉	閹
阊	閶
阋	鬩
阌	閿
阍	閽
阎	閻
阏	閼
阐	闡
阑	闌
阒	闃
阓	闠
阔	闊
阕	闋
阖	闔
阗	闐
阘	闒
阙	闕
阚	闞
阛	闤
队	隊
阳	陽
阴	陰
阵	陣
阶	階
际	際
陆	陸
陇	隴
陈	陳
陉	陘
陕	陝
陦	隯
陧	隉
陨	隕
险	險
随	隨
隐	隱
隶	隸
隽	雋
难	難
雏	雛
雠	讎
雳	靂
雾	霧
霁	霽
霡	霢
霭	靄
靓	靚
静	靜
靥	靨
鞑	韃
鞒	鞽
鞯	韉
韦	韋
韧	韌
韨	韍
韩	韓
韪	韙
韫	韞
韬	韜
韵	韻
页	頁
顶	頂
顷	頃
顸	頇
项	項
顺	順
须	須
顼	頊
顽	頑
顾	顧
顿	頓
颀	頎
颁	頒
颂	頌
颃	頏
预	預
颅	顱
领	領
颇	頗
颈	頸
颉	頡
颊	頰
颋	頲
颌	頜
颍	潁
颎	熲
颏	頦
颐	頤
频	頻
颒	頮
颓	頹
颔	頷
颕	頴
颖	穎
颗	顆
题	題
颙	顒
颚	顎
颛	顓
颜	顏
额	額
颞	顳
颟	顢
颠	顛
颡	顙
颢	顥
颣	纇
颤	顫
颥	顬
颦	顰
颧	顴
风	風
飏	颺
飐	颭
飑	颮
飒	颯
飓	颶
飔	颸
飕	颼
飖	颻
飗	飀
飘	飄
飙	飆
飚	飈
飞	飛
飨	饗
餍	饜
饣	飠
饤	飣
饥	飢
饦	飥
饧	餳
饨	飩
饩	餼
饪	飪
饫	飫
饬	飭
饭	飯
饮	飲
饯	餞
饰	飾
饱	飽
饲	飼
饳	飿
饴	飴
饵	餌
饶	饒
饷	餉
饸	餄
饹	餎
饺	餃
饻	餏
饼	餅
饽	餑
饾	餖
饿	餓
馀	餘
馁	餒
馂	餕
馃	餜
馄	餛
馅	餡
馆	館
馇	餷
馈	饋
馉	餶
馊	餿
馋	饞
馌	饁
馍	饃
馎	餺
馏	餾
馐	饈
馑	饉
馒	饅
馓	饊
馔	饌
馕	饢
马	馬
驭	馭
驮	馱
驯	馴
驰	馳
驱	驅
驲	馹
驳	駁
驴	驢
驵	駔
驶	駛
驷	駟
驸	駙
驹	駒
驺	騶
驻	駐
驼	駝
驽	駑
驾	駕
驿	驛
骀	駘
骁	驍
骂	罵
骃	駰
骄	驕
骅	驊
骆	駱
骇	駭
骈	駢
骉	驫
骊	驪
骋	騁
验	驗
骍	騂
骎	駸
骏	駿
骐	騏
骑	騎
骒	騍
骓	騅
骔	騌
骕	驌
骖	驂
骗	騙
骘	騭
骙	騤
骚	騷
骛	騖
骜	驁
骝	騮
骞	騫
骟	騸
骠	驃
骡	騾
骢	驄
骣	驏
骤	驟
骥	驥
骦	驦
骧	驤
髅	髏
髋	髖
髌	髕
鬓	鬢
鬶	鬹
魇	魘
魉	魎
鱼	魚
鱽	魛
鱾	魢
鱿	魷
鲀	魨
鲁	魯
鲂	魴
鲃	䰾
鲄	魺
鲅	鮁
鲆	鮃
鲇	鯰
鲈	鱸
鲉	鮋
鲊	鮓
鲋	鮒
鲌	鮊
鲍	鮑
鲎	鱟
鲏	鮍
鲐	鮐
鲑	鮭
鲒	鮚
鲓	鮳
鲔	鮪
鲕	鮞
鲖	鮦
鲗	鰂
鲘	鮜
鲙	鱠
鲚	鱭
鲛	鮫
鲜	鮮
鲝	鮺
鲞	鯗
鲟	鱘
鲠	鯁
鲡	鱺
鲢	鰱
鲣	鰹
鲤	鯉
鲥	鰣
鲦	鰷
鲧	鯀
鲨	鯊
鲩	鯇
鲪	鮶
鲫	鯽
鲬	鯒
鲭	鯖
鲮	鯪
鲯	鯕
鲰	鯫
鲱	鯡
鲲	鯤
鲳	鯧
鲴	鯝
鲵	鯢
鲶	鯰
鲷	鯛
鲸	鯨
鲹	鰺
鲺	鯴
鲻	鯔
鲼	鱝
鲽	鰈
鲾	鰏
鲿	鱨
鳀	鯷
鳁	鰮
鳂	鰃
鳃	鰓
鳄	鱷
鳅	鰍
鳆	鰒
鳇	鰉
鳈	鰁
鳉	鱂
鳊	鯿
鳋	鰠
鳌	鰲
鳍	鰭
鳎	鰨
鳏	鰥
鳐	鰩
鳑	鰟
鳒	鰜
鳓	鰳
鳔	鰾
鳕	鱈
鳖	鱉
鳗	鰻
鳘	鰵
鳙	鱅
鳚	䲁
鳛	鰼
鳜	鱖
鳝	鱔
鳞	鱗
鳟	鱒
鳠	鱯
鳡	鱤
鳢	鱧
鳣	鱣
鳤	䲘
鸟	鳥
鸠	鳩
鸡	雞
鸢	鳶
鸣	鳴
鸤	鳲
鸥	鷗
鸦	鴉
鸧	鶬
鸨	鴇
鸩	鴆
鸪	鴣
鸫	鶇
鸬	鸕
鸭	鴨
鸮	鴞
鸯	鴦
鸰	鴒
鸱	鴟
鸲	鴝
鸳	鴛
鸴	鷽
鸵	鴕
鸶	鷥
鸷	鷙
鸸	鴯
鸹	鴰
鸺	鵂
鸻	鴴
鸼	鵃
鸽	鴿
鸾	鸞
鸿	鴻
鹀	鵐
鹁	鵓
鹂	鸝
鹃	鵑
鹄	鵠
鹅	鵝
鹆	鵒
鹇	鷳
鹈	鵜
鹉	鵡
鹊	鵲
鹋	鶓
鹌	鵪
鹍	鵾
鹎	鵯
鹏	鵬
鹐	鵮
鹑	鶉
鹒	鶊
鹓	鵷
鹔	鷫
鹕	鶘
鹖	鶡
鹗	鶚
鹘	鶻
鹙	鶖
鹚	鶿
鹛	鶥
鹜	鶩
鹝	鷊
鹞	鷂
鹟	鶲
鹠	鶹
鹡	鶺
鹢	鷁
鹣	鶼
鹤	鶴
鹥	鷖
鹦	鸚
鹧	鷓
鹨	鷚
鹩	鷯
鹪	鷦
鹫	鷲
鹬	鷸
鹭	鷺
鹮	䴉
鹯	鸇
鹰	鷹
鹱	鸌
鹲	鸏
鹳	鸛
鹴	鸘
鹾	鹺
麦	麥
麸	麩
麹	麴
黄	黃
黉	黌
黡	黶
黩	黷
黪	黲
黾	黽
鼋	黿
鼍	鼉
鼗	鞀
鼹	鼴
齐	齊
齑	齏
齿	齒
龀	齔
龁	齕
龂	齗
龃	齟
龄	齡
龅	齙
龆	齠
龇	齜
龈	齦
龉	齬
龊	齪
龋	齲
龌	齷
龙	龍
龚	龔
龛	龕
龟	龜
鿎	䃮
鿏	䥑
鿔	鎶
鿭	鉨
𠆲	儣
𠆿	𠌥
𠉂	㒓
𠉗	𠏢
𠚳	𠠎
𠛅	剾
𠛆	𠞆
𠯟	哯
𠯠	噅
𠲥	𡅏
𠴢	𡄔
𠵸	𡄣
𠵾	㗲
𡋀	𡓾
𡋗	𡑭
𡒄	壈
𡝠	㜷
𡞱	㜢
𡭜	𡮉
𡭬	𡮣
𡶴	嵼
𢀖	巠
𢋈	㢝
𢘝	𢣚
𢘞	𢣭
𢙓	懀
𢛯	㦎
𢫊	𢷮
𢫞	𢶫
𢫬	摋
𢬦	𢹿
𢭏	擣
𢽾	斅
𣆐	曥
𣍨	𦢈
𣍯	腪
𣍰	脥
𣎑	臗
𣐤	欍
𣑶	𣠲
𣗋	欓
𣘓	𣞻
𣘴	檭
𣘷	𣝕
𣭤	𣯴
𣲗	湋
𣲘	潕
𣶩	澅
𣶫	𣿉
𣸣	濆
𣺼	灙
𣺽	𤁣
𣽷	瀃
𤆡	熓
𤇃	爄
𤇄	熌
𤈶	熉
𤈷	㷿
𤊀	𤒎
𤋏	熡
𤞤	玁
𤠋	㺏
𤦀	瓕
𤩽	瓛
𤳄	𤳸
𤶧	𤸫
𤽯	㿧
𤾀	皟
𥅘	𥌃
𥅴	䀹
𥆧	瞤
𥇢	䁪
𥐟	礒
𥐯	𥖅
𥐰	𥕥
𥐻	碙
𥧂	𥨐
𥬀	䉙
𥬞	籋
𥬠	篘
𥭉	𥵊
𥮋	𥸠
𥮜	䉲
𥱔	𥵃
𥹥	𥼽
𥺅	䊭
𥺇	𥽖
𦈈	𥿊
𦈉	緷
𦈋	綇
𦈌	綀
𦈎	繟
𦈏	緍
𦈐	縺
𦈑	緸
𦈒	𦂅
𦈓	䋿
𦈔	縎
𦈕	緰
𦈖	䌈
𦈗	𦃄
𦈘	䌋
𦈙	䌰
𦈚	縬
𦈛	繓
𦈜	䌖
𦈝	繏
𦈞	䌟
𦈟	䌝
𦈠	䌥
𦈡	繻
𦛨	朥
𦝼	膢
𦟗	𦣎
𦨩	𦪽
𦰴	䕳
𧉞	䗿
𧒭	𧔥
𧮪	詀
𧳕	𧳟
𧹑	䞈
𧹓	𧶔
𧹕	䝻
𧹖	賟
𧹗	贃
𧿈	𨇁
𨀱	𨄣
𨁴	𨅍
𨂺	𨈊
𨄄	𨈌
𨅫	𨇞
𨅬	躝
𨉗	軉
𨐅	軗
𨐆	𨊻
𨐇	𨏠
𨐈	輄
𨐉	𨎮
𨐊	𨏥
𨑹	䢨
𨤰	𨤻
𨰾	鎷
𨰿	釳
𨱀	𨥛
𨱁	鈠
𨱂	鈋
𨱃	鈲
𨱄	鈯
𨱅	鉁
𨱆	龯
𨱇	銶
𨱈	鋉
𨱉	鍄
𨱊	𨧱
𨱋	錂
𨱌	鏆
𨱍	鎯
𨱎	鍮
𨱏	鎝
𨱐	𨫒
𨱑	鐄
𨱒	鏉
𨱓	鐎
𨱔	鐏
𨱕	𨮂
𨱖	䥩
𨷿	䦳
𨸀	𨳕
𨸁	𨳑
𨸂	閍
𨸃	閐
𨸄	䦘
𨸅	𨴗
𨸆	𨵩
𨸇	𨵸
𨸉	𨶀
𨸊	𨶏
𨸋	𨶲
𨸌	𨶮
𨸎	𨷲
𨸘	𨽏
𨸟	䧢
𩏼	䪏
𩏽	𩏪
𩏾	𩎢
𩏿	䪘
𩐀	䪗
𩖕	𩓣
𩖖	顃
𩖗	䫴
𩙥	颰
𩙦	𩗀
𩙧	𩗡
𩙨	𩘹
𩙩	𩘀
𩙪	颷
𩙫	颾
𩙬	𩘺
𩙭	𩘝
𩙮	䬘
𩙯	䬝
𩙰	𩙈
𩟿	𩚛
𩠀	𩚥
𩠁	𩚵
𩠂	𩛆
𩠃	𩛩
𩠅	𩟐
𩠆	𩜦
𩠇	䭀
𩠈	䭃
𩠉	𩜇
𩠊	𩜵
𩠋	𩝔
𩠌	餸
𩠎	𩞄
𩠏	𩞦
𩠠	𩠴
𩧦	𩡺
𩧨	駎
𩧩	𩤊
𩧪	䮾
𩧫	駚
𩧬	𩢡
𩧭	䭿
𩧮	𩢾
𩧯	驋
𩧰	䮝
𩧱	𩥉
𩧲	駧
𩧳	𩢸
𩧴	駩
𩧵	𩢴
𩧶	𩣏
𩧺	駶
𩧻	𩣵
𩧼	𩣺
𩧿	䮠
𩨀	騔
𩨁	䮞
𩨃	騝
𩨄	騪
𩨅	𩤸
𩨆	𩤙
𩨇	䮫
𩨈	騟
𩨉	𩤲
𩨊	騚
𩨋	𩥄
𩨌	𩥑
𩨍	𩥇
𩨎	龭
𩨏	䮳
𩨐	𩧆
𩬣	𩭙
𩬤	𩰀
𩯒	𩯳
𩲒	𩳤
𩽹	魥
𩽺	𩵩
𩽻	𩵹
𩽼	鯶
𩽽	𩶱
𩽾	鮟
𩽿	𩶰
𩾁	鯄
𩾂	䲖
𩾃	鮸
𩾄	𩷰
𩾅	𩸃
𩾆	𩸦
𩾇	鯱
𩾈	䱙
𩾊	䱬
𩾋	䱰
𩾌	鱇
𩾎	𩽇
𪉂	䲰
𪉃	鳼
𪉄	𩿪
𪉅	𪀦
𪉆	鴲
𪉈	鴜
𪉉	𪁈
𪉊	鷨
𪉋	𪀾
𪉌	𪁖
𪉍	鵚
𪉎	𪂆
𪉏	𪃏
𪉐	𪃍
𪉑	鷔
𪉒	𪄕
𪉓	𪈼
𪉔	𪄆
𪉕	𪇳
𪎈	䴬
𪎉	麲
𪎊	麨
𪎋	䴴
𪎌	麳
𪎍	𪋿
𪔭	𪔵
𪚏	𪘀
𪚐	𪘯
𪞝	凙
𪟝	勣
𪡏	嗹
𪢮	圞
𪣻	塿
𪨊	㞞
𪨗	屩
𪨶	輋
𪩘	巘
𪻐	瑽
𪾢	睍
𫁡	鴗
𫂈	䉬
𫄧	綖
𫄨	絺
𫄷	繶
𫄸	纁
𫇭	蒍
𫌀	襀
𫌨	覼
𫍙	訑
𫍢	譊
𫍣	詷
𫍯	諴
𫍰	諰
𫍲	謏
𫍽	譞
𫏋	蹻
𫐄	軏
𫐆	轣
𫐉	軨
𫐐	輗
𫐓	輮
𫑡	鄳
𫓧	鈇
𫓩	鏦
𫓯	銈
𫓶	鋗
𫓹	錤
𫔍	鐇
𫔎	鐍
𫔶	闑
𫖮	顗
𫖯	頫
𫖳	頵
𫖸	願
𫗠	餦
𫗦	餔
𫗧	餗
𫗮	餭
𫗴	饘
𫘜	馼
𫘝	駃
𫘣	駻
𫘤	騃
𫘦	騊
𫘧	騄
𫘨	騠
𫘪	騵
𫘬	騱
𫚈	鱮
𫚉	魟
𫚒	鮄
𫚔	鮰
𫚕	鰤
𫚖	鮆
𫚙	鯆
𫚭	鱲
𫛛	鳷
𫛞	鴃
𫛢	鸋
𫛭	鵟
𫛶	鶒
𫛸	鶗
𫞩	璊
𫟅	綡
𫟦	䡵
𫟷	鉝
𫟹	鉷
𫟼	鐽
𫠆	頍
𫠊	䮄
𫠜	齯
𫢸	僤
𫫇	噁
𫭟	塸
𫭢	埨
𫭼	𡑍
𫮃	墠
𫰛	娙
𫵷	㠣
𫶇	嵽
𫷷	廞
𫸩	彄
𬀩	暐
𬀪	晛
𬂩	梜
𬃊	櫍
𬇕	澫
𬇙	浿
𬇹	漍
𬉼	熰
𬊈	燖
𬊤	燀
𬍛	瓅
𬍡	璗
𬍤	璕
𬒈	礐
𬒗	𥗽
𬓼	穨
𬕂	篢
𬘓	紃
𬘘	紞
𬘡	絪
𬘩	綎
𬘫	綄
𬘬	綪
𬘭	綝
𬘯	綧
𬙂	縯
𬙊	纆
𬙋	纕
𬜬	蔄
𬜯	䓣
𬟁	虉
𬟽	蝀
𬣙	訏
𬣞	詝
𬣡	諓
𬣳	詪
𬤇	諲
𬤊	諟
𬤝	譓
𬤥	譔
𬨂	軝
𬨎	輶
𬩽	鄩
𬪩	醲
𬬩	釴
𬬭	錀
𬬮	鋹
𬬱	釿
𬬸	鉥
𬬹	鉮
𬬻	鑪
𬬿	鉊
𬭁	鉧
𬭊	𨧀
𬭎	鋐
𬭚	錞
𬭛	𨨏
𬭤	鍭
𬭩	鎓
𬭬	鏏
𬭯	䥕
𬭳	𨭎
𬭶	𨭆
𬭸	鏻
𬭼	鐩
𬮱	闉
𬮿	隑
𬯀	隮
𬯎	隤
𬱖	頔
𬱟	頠
𬳵	駓
𬳶	駉
𬳽	駪
𬳿	駼
𬴂	騑
𬴃	騞
𬴊	驎
𬶋	鮈
𬶍	鮀
𬶏	鮠
𬶐	鮡
𬶟	鯻
𬶠	鰊
𬶨	鱀
𬶭	鰶
𬶮	鱚
𬷕	鵏
𬸘	鶠
𬸚	鸑
𬸣	鶱
𬸦	鷟
𬸪	鷭
𬹼	齘
𬺈	齮
𬺓	齼
𰻝	𰻞
0只支持	0只支持
0只支援	0只支援
0周后	0周後
0天后	0天後
0只	0隻
0余	0餘
0出。	0齣。
0出电影	0齣電影
0出，	0齣，
1只支持	1只支持
1只支援	1只支援
1周后	1周後
1天后	1天後
1只	1隻
1余	1餘
2只支持	2只支持
2只支援	2只支援
2周后	2周後
2天后	2天後
2只	2隻
2余	2餘
3只支持	3只支持
3只支援	3只支援
3周后	3周後
3天后	3天後
3只	3隻
3余	3餘
4只支持	4只支持
4只支援	4只支援
4周后	4周後
4天后	4天後
4只	4隻
4余	4餘
5只支持	5只支持
5只支援	5只支援
5周后	5周後
5天后	5天後
5只	5隻
5余	5餘
6只支持	6只支持
6只支援	6只支援
6周后	6周後
6天后	6天後
6只	6隻
6余	6餘
7只支持	7只支持
7只支援	7只支援
7周后	7周後
7天后	7天後
7只	7隻
7余	7餘
8只支持	8只支持
8只支援	8只支援
8周后	8周後
8天后	8天後
8只	8隻
8余	8餘
9只支持	9只支持
9只支援	9只支援
9周后	9周後
9天后	9天後
9只	9隻
9余	9餘
I’	I’
e’	e’
u’	u’
·范	·范
’m	’m
’re	’re
’s	’s
’t	’t
、面点	、麵點
。个中	。箇中
〇周后	〇周後
〇只	〇隻
〇余	〇餘
》里	》裡
“	「
”	」
‘	『
’	』
一干二净	一乾二淨
一伙人	一伙人
一伙头	一伙頭
一伙食	一伙食
一并	一併
一个	一個
一个准	一個準
一划	一划
一半只	一半只
一吊钱	一吊錢
一周后	一周後
一地里	一地裡
一伙	一夥
一天后	一天後
一天钟	一天鐘
一干人	一干人
一干家中	一干家中
一干弟兄	一干弟兄
一干弟子	一干弟子
一干部下	一干部下
一斗斗	一斗斗
一树百获	一樹百穫
一准	一準
一争两丑	一爭兩醜
一物克一物	一物剋一物
一目了然	一目了然
一碗面	一碗麵
一扎	一紮
一冲	一衝
一厘一毫	一釐一毫
一锅面	一鍋麵
一只	一隻
一面食	一面食
一余	一餘
一发千钧	一髮千鈞
一哄而散	一鬨而散
一出剧	一齣劇
一出喜剧	一齣喜劇
一出好戏	一齣好戲
一出子	一齣子
一出悲剧	一齣悲劇
一出戏	一齣戲
一出电影	一齣電影
丁丁当当	丁丁當當
丁丑	丁丑
七个	七個
七周后	七周後
七天后	七天後
七情六欲	七情六慾
七扎	七紮
七只	七隻
七余	七餘
万俟	万俟
万旗	万旗
三个	三個
三周后	三周後
三天后	三天後
三征七辟	三徵七辟
三准	三準
三扎	三紮
三统历	三統曆
三统历史	三統歷史
三只	三隻
三余	三餘
三出戏	三齣戲
上天里	上天里
上梁山	上梁山
上台面	上檯面
上签了	上簽了
上签名	上簽名
上签字	上簽字
上签定	上簽定
上签写	上簽寫
上签收	上簽收
上签发	上簽發
上签约	上簽約
上签署	上簽署
上签订	上簽訂
上签证	上簽證
上签	上籤
上系上	上繫上
上课钟	上課鐘
上面糊	上面糊
下文里	下文裡
下注解	下注解
下签了	下簽了
下签名	下簽名
下签字	下簽字
下签定	下簽定
下签写	下簽寫
下签收	下簽收
下签发	下簽發
下签约	下簽約
下签署	下簽署
下签订	下簽訂
下签证	下簽證
下签	下籤
下课钟	下課鐘
不干不净	不乾不淨
不干胶	不乾膠
不克自制	不克自制
不加自制	不加自制
不占凶吉	不占凶吉
不占卜	不占卜
不占吉凶	不占吉凶
不占算	不占算
不只	不只
不太准	不太準
不好干涉	不好干涉
不好干預	不好干預
不好干预	不好干預
不嫌母丑	不嫌母醜
不寒而栗	不寒而慄
不吊，	不弔，
不卷	不捲
不采	不採
不斗胆	不斗膽
不斗膽	不斗膽
不断发	不斷發
不每只	不每只
不谷	不穀
不托	不託
不负所托	不負所托
不通吊庆	不通弔慶
不丑	不醜
不采声	不采聲
不采聲	不采聲
不食乾腊	不食乾腊
不食干腊	不食乾腊
不斗	不鬥
丑三	丑三
丑年	丑年
丑日	丑日
丑旦	丑旦
丑时	丑時
丑月	丑月
丑表功	丑表功
丑角	丑角
世界杯	世界盃
世纪里	世紀裡
世纪钟	世紀鐘
世纪钟表	世紀鐘錶
丢丑	丟醜
并合并	並合併
并吞下	並吞下
并发动	並發動
并发展	並發展
并发布	並發布
并发现	並發現
并发表	並發表
并行	並行
中国国际信托投资公司	中國國際信托投資公司
中型钟	中型鐘
中型钟表面	中型鐘表面
中型钟表	中型鐘錶
中型钟面	中型鐘面
中境里	中境里
中岳	中嶽
中庄子	中庄子
中文里	中文裡
中断发	中斷發
中签了	中簽了
中签名	中簽名
中签字	中簽字
中签定	中簽定
中签写	中簽寫
中签收	中簽收
中签发	中簽發
中签约	中簽約
中签署	中簽署
中签订	中簽訂
中签证	中簽證
中签	中籤
中风后	中風後
丰仪	丰儀
丰儀	丰儀
丰姿	丰姿
丰容	丰容
丰情	丰情
丰标	丰標
丰標	丰標
丰标不凡	丰標不凡
丰標不凡	丰標不凡
丰神	丰神
丰茸	丰茸
丰采	丰采
丰韵	丰韻
丰韻	丰韻
丹棱	丹稜
主仆	主僕
主干	主幹
主钟差	主鐘差
主钟曲线	主鐘曲線
乃系	乃係
么九	么九
么二三	么二三
么元	么元
么兒	么兒
么半	么半
么叔	么叔
么喝	么喝
么女	么女
么妹	么妹
么姓	么姓
么姨	么姨
么娘	么娘
么媽	么媽
么孃	么孃
么子	么子
么弟	么弟
么正	么正
么氏	么氏
么爸	么爸
么爹	么爹
么爺	么爺
么篇	么篇
么舅	么舅
么蛾子	么蛾子
么雞	么雞
么鳳	么鳳
么麼	么麼
之一只	之一只
之二只	之二只
之八九只	之八九只
之子于归	之子于歸
之子于歸	之子于歸
之征	之徵
之托	之託
之钟	之鐘
之鉴	之鑑
之余	之餘
乙丑	乙丑
九世之仇	九世之讎
九个	九個
九周后	九周後
九天后	九天後
九谷	九穀
九扎	九紮
九只	九隻
九余	九餘
干干	乾乾
干干净净	乾乾淨淨
干井	乾井
干个够	乾個夠
干儿	乾兒
干冰	乾冰
干冷	乾冷
干刻版	乾刻版
干剥剥	乾剝剝
干咳	乾咳
干咽	乾咽
干哥	乾哥
干哭	乾哭
干唱	乾唱
干啼	乾啼
干乔	乾喬
干呕	乾嘔
干哕	乾噦
干嚎	乾嚎
干回付	乾回付
干圆洁净	乾圓潔淨
干坞	乾塢
干女儿	乾女兒
干奴才	乾奴才
干妹	乾妹
干姊	乾姊
干姐	乾姐
干娘	乾娘
干妈	乾媽
干子	乾子
干季	乾季
干尸	乾屍
干屎橛	乾屎橛
干巴	乾巴
干式	乾式
干弟	乾弟
干急	乾急
干性	乾性
干打雷	乾打雷
干折	乾折
干拌面	乾拌麵
干撂台	乾撂台
干撇下	乾撇下
干擦	乾擦
干支剌	乾支剌
干支支	乾支支
干料	乾料
干旱	乾旱
干暖	乾暖
干材	乾材
干村沙	乾村沙
干杯	乾杯
干果	乾果
干枯	乾枯
干柴	乾柴
干柴烈火	乾柴烈火
干梅	乾梅
干死	乾死
干池	乾池
干没	乾沒
干洗	乾洗
干涸	乾涸
干凉	乾涼
干净	乾淨
干渠	乾渠
干渴	乾渴
干沟	乾溝
干漆	乾漆
干涩	乾澀
干湿	乾濕
干熬	乾熬
干热	乾熱
干灯盏	乾燈盞
干燥	乾燥
干爸	乾爸
干爹	乾爹
干爽	乾爽
干片	乾片
干物	乾物
干生受	乾生受
干生子	乾生子
干产	乾產
干田	乾田
干疥	乾疥
干瘦	乾瘦
干瘪	乾癟
干癣	乾癬
干瘾	乾癮
干白儿	乾白兒
干白葡萄酒	乾白葡萄酒
干眼	乾眼
干瞪眼	乾瞪眼
干礼	乾禮
干稿	乾稿
干笑	乾笑
干等	乾等
干篾片	乾篾片
干粉	乾粉
干粮	乾糧
干红葡萄酒	乾紅葡萄酒
干结	乾結
干丝	乾絲
干纲	乾綱
干绷	乾繃
干耗	乾耗
干肉片	乾肉片
干股	乾股
干肥	乾肥
干脆	乾脆
干脆面	乾脆麵
干花	乾花
干刍	乾芻
干苔	乾苔
干茨腊	乾茨臘
干茶钱	乾茶錢
干草	乾草
干菜	乾菜
干落	乾落
干姜	乾薑
干薪	乾薪
干虔	乾虔
干号	乾號
干血浆	乾血漿
干衣	乾衣
干裂	乾裂
干亲	乾親
乾象历	乾象曆
乾象曆	乾象曆
干贝	乾貝
干货	乾貨
干躁	乾躁
干逼	乾逼
干酪	乾酪
干酵母	乾酵母
干醋	乾醋
干重	乾重
干量	乾量
干锅	乾鍋
干阿奶	乾阿奶
干雷	乾雷
干电	乾電
干霍乱	乾霍亂
干颡	乾顙
干食	乾食
干饭	乾飯
干馆	乾館
干糇	乾餱
干馏	乾餾
干鱼	乾魚
干鲜	乾鮮
干面	乾麵
乱斗	亂鬥
乱哄哄	亂鬨鬨
了然后	了然後
事有斗巧	事有鬥巧
事里	事裡
二不棱登	二不稜登
二个	二個
二只得	二只得
二周后	二周後
二天后	二天後
二缶钟惑	二缶鐘惑
二老板	二老板
二虎相斗	二虎相鬥
二里头	二里頭
二里頭	二里頭
二只	二隻
二余	二餘
于于	于于
于仁泰	于仁泰
于仲文	于仲文
于佳卉	于佳卉
于來山	于來山
于来山	于來山
于伟国	于偉國
于偉國	于偉國
于光远	于光遠
于光遠	于光遠
于克-兰多县	于克-蘭多縣
于克-蘭多縣	于克-蘭多縣
于克勒	于克勒
于再清	于再清
于冕	于冕
于冠华	于冠華
于冠華	于冠華
于凌奎	于凌奎
于凌辰	于凌辰
于勒	于勒
于化虎	于化虎
于占元	于占元
于友泽	于友澤
于友澤	于友澤
于台烟	于台煙
于台煙	于台煙
于右任	于右任
于吉	于吉
于和伟	于和偉
于和偉	于和偉
于品海	于品海
于国桢	于國楨
于國楨	于國楨
于坚	于堅
于堅	于堅
于大宝	于大寶
于大寶	于大寶
于天仁	于天仁
于天龍	于天龍
于天龙	于天龍
于奇库杜克	于奇庫杜克
于奇庫杜克	于奇庫杜克
于姓	于姓
于娜	于娜
于娟	于娟
于子千	于子千
于孔兼	于孔兼
于学忠	于學忠
于學忠	于學忠
于家堡	于家堡
于寘	于寘
于宝轩	于寶軒
于寶軒	于寶軒
于小伟	于小偉
于小偉	于小偉
于小彤	于小彤
于小惠	于小惠
于少保	于少保
于山国	于山國
于山國	于山國
于山岛	于山島
于山島	于山島
于帅	于帥
于帥	于帥
于康震	于康震
于广洲	于廣洲
于廣洲	于廣洲
于式枚	于式枚
于从濂	于從濂
于從濂	于從濂
于德海	于德海
于志宁	于志寧
于志寧	于志寧
于忠肃集	于忠肅集
于忠肅集	于忠肅集
于慎行	于慎行
于慧	于慧
于成龍	于成龍
于成龙	于成龍
于承惠	于承惠
于振	于振
于振武	于振武
于敏	于敏
于斌	于斌
于斯塔德	于斯塔德
于斯納爾斯貝里	于斯納爾斯貝里
于斯纳尔斯贝里	于斯納爾斯貝里
于斯达尔	于斯達爾
于斯達爾	于斯達爾
于明涛	于明濤
于明濤	于明濤
于是之	于是之
于晨楠	于晨楠
于晴	于晴
于会泳	于會泳
于會泳	于會泳
于根伟	于根偉
于根偉	于根偉
于格	于格
于枫	于楓
于楓	于楓
于榮光	于榮光
于荣光	于榮光
于樂	于樂
于树洁	于樹潔
于樹潔	于樹潔
于欣	于欣
于欣源	于欣源
于正昇	于正昇
于正昌	于正昌
于氏	于氏
于江震	于江震
于波	于波
于洋	于洋
于洪区	于洪區
于洪區	于洪區
于浩威	于浩威
于湘兰	于湘蘭
于湘蘭	于湘蘭
于汉超	于漢超
于漢超	于漢超
于澄	于澄
于泽尔	于澤爾
于澤爾	于澤爾
于涛	于濤
于濤	于濤
于熙珍	于熙珍
于尔岑	于爾岑
于爾岑	于爾岑
于尔根	于爾根
于爾根	于爾根
于尔里克	于爾里克
于爾里克	于爾里克
于特森	于特森
于玉立	于玉立
于田	于田
于禁	于禁
于秀敏	于秀敏
于立成	于立成
于素秋	于素秋
于美人	于美人
于芷山	于芷山
于若木	于若木
于荫霖	于蔭霖
于蔭霖	于蔭霖
于衡	于衡
于西翰	于西翰
于謙	于謙
于谦	于謙
于謹	于謹
于谨	于謹
于貝爾	于貝爾
于贝尔	于貝爾
于贈	于贈
于赠	于贈
于越	于越
于軍	于軍
于逸堯	于逸堯
于道泉	于道泉
于远伟	于遠偉
于遠偉	于遠偉
于都县	于都縣
于都縣	于都縣
于里察	于里察
于闐	于闐
于阗	于闐
于双戈	于雙戈
于雙戈	于雙戈
于云鹤	于雲鶴
于雲鶴	于雲鶴
于震	于震
于靖	于靖
于非暗	于非闇
于非闇	于非闇
于韋斯屈萊	于韋斯屈萊
于韦斯屈莱	于韋斯屈萊
于風政	于風政
于风政	于風政
于余曲折	于餘曲折
于鬯	于鬯
于魁智	于魁智
于凤桐	于鳳桐
于鳳桐	于鳳桐
于凤至	于鳳至
于鳳至	于鳳至
于默奥	于默奧
于默奧	于默奧
云乎	云乎
云云	云云
云何	云何
云敞	云敞
云为	云為
云為	云為
云然	云然
云尔	云爾
云：	云：
五个	五個
五周后	五周後
五天后	五天後
五峰县	五峯縣
五岳	五嶽
五谷	五穀
五扎	五紮
五脏	五臟
五行生克	五行生剋
五谷王北街	五谷王北街
五谷王南街	五谷王南街
五只	五隻
五余	五餘
井干	井幹
井里	井裡
亘古	亙古
交托	交託
交游	交遊
交哄	交鬨
亦云	亦云
京沈	京瀋
亮丑	亮醜
亮钟	亮鐘
人云	人云
人如风后入江云	人如風後入江雲
人干的	人幹的
人欲	人慾
人数只	人數只
人数里	人數裡
人物志	人物誌
人生天里	人生天里
人发指	人髮指
什锦面	什錦麵
仁贵	仁貴
介胄	介冑
他干的	他幹的
付托	付託
仙后	仙后
仙后座	仙后座
仙游	仙遊
代数里	代數裡
代理发	代理發
代码表	代碼表
代表	代表
以自制	以自制
仲裁制	仲裁制
件钟	件鐘
价川	价川
仿制	仿製
伊于湖底	伊于湖底
伊府面	伊府麵
伊斯兰教历	伊斯蘭教曆
伊斯兰教历史	伊斯蘭教歷史
伊斯兰历	伊斯蘭曆
伊斯兰历史	伊斯蘭歷史
伊东怜	伊東怜
伊東怜	伊東怜
伊尔汗历表	伊爾汗曆表
伊达里子	伊達里子
伊适杰	伊適杰
伊適杰	伊適杰
伊里布	伊里布
伊郁	伊鬱
伏几	伏几
伐罪吊民	伐罪弔民
休克期	休克期
休征	休徵
伙头	伙頭
伴游	伴遊
但云	但云
位准	位準
低洼	低洼
住扎	住紮
占毕	佔畢
占头筹	佔頭籌
占高枝儿	佔高枝兒
何杰	何杰
余三勝	余三勝
余三胜	余三勝
余光中	余光中
余光生	余光生
余力为	余力為
余力為	余力為
余威德	余威德
余子明	余子明
余思敏	余思敏
余杰	余杰
佛历	佛曆
佛罗棱萨	佛羅稜薩
佛钟	佛鐘
作品里	作品裡
作准	作準
你夸	你誇
佣金	佣金
佣鈿	佣鈿
佣钿	佣鈿
佣錢	佣錢
佣钱	佣錢
佳里鎮	佳里鎮
佳肴	佳餚
并一不二	併一不二
并入	併入
并兼	併兼
并到	併到
并力	併力
并合	併合
并名	併名
并吞	併吞
并拢	併攏
并查集	併查集
并案	併案
并为一家	併為一家
并为一体	併為一體
并叠	併疊
并发型模式	併發型模式
并发模式	併發模式
并发症	併發症
并发重症	併發重症
并科	併科
并网	併網
并线	併線
并肩子	併肩子
并购	併購
并集	併集
并骨	併骨
使其斗	使其鬥
來栖	來栖
来栖	來栖
侍仆	侍僕
依依不舍	依依不捨
依托	依託
侵并	侵併
局促	侷促
系指	係指
系为	係為
保险柜	保險柜
信井里	信井里
信托贸易	信托貿易
信托	信託
修杰楷	修杰楷
修筑前	修築前
修筑后	修築後
修胡刀	修鬍刀
俯冲	俯衝
个月里	個月裡
个里	個裡
个钟	個鐘
个钟表	個鐘錶
们干的	們幹的
幸免	倖免
幸存	倖存
幸幸	倖幸
候复	候覆
倚闲	倚閑
倛丑	倛醜
借鉴	借鑑
倦游	倦遊
假发票	假發票
假里	假裡
假托	假託
假发	假髮
偎干	偎乾
停停当当	停停當當
停征	停徵
停制	停製
备注	備註
家伙	傢伙
催并	催併
佣仆	傭僕
傲游	傲遊
傲霜斗雪	傲霜鬥雪
传位于四太子	傳位于四太子
傳位于四太子	傳位于四太子
债累累	債纍纍
傻里傻气	傻裡傻氣
仅余	僅餘
像赞	像讚
仆人	僕人
仆使	僕使
仆仆	僕僕
仆僮	僕僮
仆吏	僕吏
仆固怀恩	僕固懷恩
仆夫	僕夫
仆姑	僕姑
仆婢	僕婢
仆妇	僕婦
仆射	僕射
仆少	僕少
仆役	僕役
仆从	僕從
仆憎	僕憎
仆欧	僕歐
仆程	僕程
仆虽罢驽	僕雖罷駑
侥幸	僥倖
僮仆	僮僕
雇人	僱人
雇佣	僱傭
雇到	僱到
雇工	僱工
雇船	僱船
雇请	僱請
雇车	僱車
雇农	僱農
仪征	儀徵
仪范	儀範
亿个	億個
亿周后	億周後
亿天后	億天後
亿只	億隻
亿余	億餘
俭仆	儉僕
俭朴	儉樸
俭确之教	儉确之教
儉确之教	儉确之教
儒略改革历	儒略改革曆
儒略改革历史	儒略改革歷史
儒略历	儒略曆
儒略历史	儒略歷史
尽尽	儘儘
尽先	儘先
尽其所有	儘其所有
尽可能	儘可能
尽快	儘快
尽早	儘早
尽是	儘是
尽管	儘管
尽自	儘自
尽速	儘速
尽量	儘量
优游	優遊
兀术	兀朮
元凶	元兇
兆个	兆個
兆余	兆餘
凶刀	兇刀
凶器	兇器
凶嫌	兇嫌
凶巴巴	兇巴巴
凶徒	兇徒
凶悍	兇悍
凶恶	兇惡
凶手	兇手
凶案	兇案
凶枪	兇槍
凶横	兇橫
凶残	兇殘
凶杀	兇殺
凶犯	兇犯
凶狠	兇狠
凶猛	兇猛
凶疑	兇疑
凶相	兇相
凶险	兇險
先采	先採
先进制造	先進製造
光致致	光緻緻
克期间	克期間
免征	免徵
党太尉	党太尉
党姓	党姓
党家	党家
党怀英	党懷英
党懷英	党懷英
党进	党進
党進	党進
党項	党項
党项	党項
入侵并	入侵並
内卷化	內捲化
内脏	內臟
内制	內製
内面包	內面包
内面包的	內面包的
内斗	內鬥
内哄	內鬨
全干	全乾
两个	兩個
两周后	兩周後
两天后	兩天後
两杆	兩桿
两扎	兩紮
两虎共斗	兩虎共鬥
两只	兩隻
两余	兩餘
两鼠斗穴	兩鼠鬥穴
两出	兩齣
八个	八個
八周后	八周後
八天后	八天後
八字胡	八字鬍
八扎	八紮
八蜡	八蜡
八只	八隻
八余	八餘
公仔面	公仔麵
公仆	公僕
公孙丑	公孫丑
公寓里	公寓裡
公寓里弄	公寓里弄
公干	公幹
公历	公曆
公历史	公歷史
公里海	公里海
公余	公餘
六么	六么
六个	六個
六周后	六周後
六天后	六天後
六楼后座	六樓后座
六樓后座	六樓后座
六谷	六穀
六扎	六紮
六冲	六衝
六只	六隻
六余	六餘
共和历	共和曆
共和历史	共和歷史
其一只	其一只
其二只	其二只
其八九只	其八九只
其次辟地	其次辟地
其余	其餘
典范	典範
兼并	兼併
冉有仆	冉有僕
冗余	冗餘
冤仇	冤讎
冥蒙	冥濛
冬山庄	冬山庄
冬游	冬遊
冰山里	冰山裡
冶游	冶遊
冷面天使	冷面天使
冷面杀手	冷面殺手
冷面殺手	冷面殺手
冷面相	冷面相
冷面笑匠	冷面笑匠
冷面	冷麵
准三后	准三后
准保护	准保護
准保護	准保護
准保释	准保釋
准保釋	准保釋
凌蒙初	凌濛初
凝炼	凝鍊
几上	几上
几几	几几
几凳	几凳
几子	几子
几旁	几旁
几杖	几杖
几案	几案
几椅	几椅
几榻	几榻
几净窗明	几淨窗明
几淨窗明	几淨窗明
几筵	几筵
几面上	几面上
凶征	凶徵
凶相毕露	凶相畢露
出乖弄丑	出乖弄醜
出乖露丑	出乖露醜
出征收	出征收
出游	出遊
出丑	出醜
函数里	函數裡
分别致	分别致
分半钟	分半鐘
分多钟	分多鐘
分子钟	分子鐘
分子云	分子雲
分钟	分鐘
分钟里	分鐘裡
刑余	刑餘
划一桨	划一槳
划一槳	划一槳
划不來	划不來
划不来	划不來
划了一会	划了一會
划了一會	划了一會
划來划去	划來划去
划来划去	划來划去
划具	划具
划到岸	划到岸
划到江心	划到江心
划动	划動
划動	划動
划去	划去
划子	划子
划得來	划得來
划得来	划得來
划拳	划拳
划桨	划槳
划槳	划槳
划水	划水
划着獨木舟	划着獨木舟
划算	划算
划船	划船
划艇	划艇
划著	划著
划行	划行
划走	划走
划起	划起
划进	划進
划進	划進
划过	划過
划過	划過
划龍舟	划龍舟
划龙舟	划龍舟
划龍船	划龍船
划龙船	划龍船
判断发	判斷發
别辟	別闢
利欲	利慾
刮起来	刮起來
刮胡	刮鬍
到山里	到山裡
制冷机	制冷機
制钟	制鐘
刻半钟	刻半鐘
刻多钟	刻多鐘
刻钟	刻鐘
剃发	剃髮
剃胡	剃鬍
剃须	剃鬚
削发	削髮
削面	削麵
克剥	剋剝
克扣	剋扣
克星	剋星
克期	剋期
克死	剋死
克薄	剋薄
前往	前往
前面店	前面店
剖厘	剖釐
刚干	剛乾
刚雇	剛僱
剥制	剝製
剩余	剩餘
剪其发	剪其髮
剪发	剪髮
割舍	割捨
创获	創穫
创制	創製
铲出	剷出
铲刈	剷刈
铲平	剷平
铲除	剷除
铲头	剷頭
划入	劃入
划为	劃為
刘芸后	劉芸后
劉芸后	劉芸后
力争上游	力爭上遊
功勋	功勳
加氢精制	加氫精制
劫余	劫餘
勃郁	勃鬱
勤仆	勤僕
勤朴	勤樸
勋劳	勳勞
勋业	勳業
勋爵	勳爵
勋章	勳章
勋绩	勳績
勾干	勾幹
勾心斗角	勾心鬥角
勾魂荡魄	勾魂蕩魄
包干	包幹
包准	包準
包谷	包穀
包扎	包紮
包制	包製
匏系	匏繫
北山索面	北山索麵
北仑河	北崙河
北岳	北嶽
北回线	北迴線
北回铁路	北迴鐵路
匪干	匪幹
区里有	區裡有
区里的	區裡的
十个	十個
十出家	十出家
十出击	十出擊
十出生	十出生
十出祁山	十出祁山
十出头	十出頭
十出頭	十出頭
十周后	十周後
十天后	十天後
十扎	十紮
十只	十隻
十余	十餘
十出	十齣
千个	千個
千只可	千只可
千只够	千只夠
千只夠	千只夠
千只怕	千只怕
千只能	千只能
千只足够	千只足夠
千只足夠	千只足夠
千周后	千周後
千天后	千天後
千扎	千紮
千回百折	千迴百折
千回百转	千迴百轉
千钧一发	千鈞一髮
千只	千隻
千余	千餘
升高后	升高後
半干	半乾
半制品	半制品
半只可	半只可
半只够	半只夠
半只	半隻
协防	協防
南京钟	南京鐘
南京钟表	南京鐘錶
南宫适	南宮适
南宮适	南宮适
南屏晚钟	南屏晚鐘
南岳	南嶽
南筑	南筑
南回线	南迴線
南回铁路	南迴鐵路
南游	南遊
博采	博採
博杰普尔	博杰普爾
博杰普爾	博杰普爾
博尔术	博爾朮
占了卜	占了卜
印累绶若	印纍綬若
印制	印製
印鉴	印鑑
卵与石斗	卵與石鬥
卷发动	卷發動
卷发售	卷發售
卷发展	卷發展
卷发布	卷發布
卷发现	卷發現
卷发生	卷發生
卷发表	卷發表
卷发起	卷發起
卷须	卷鬚
厂部	厂部
原子钟	原子鐘
原文里	原文裡
原钟	原鐘
历物之意	厤物之意
去山里	去山裡
参数只	參數只
参数里	參數裡
反反复复	反反覆覆
反应制得	反應製得
反朴归真	反樸歸真
反冲	反衝
反复制	反複製
反复	反覆
反覆	反覆
取舍	取捨
受雇	受僱
受托	受託
丛林里	叢林裡
口干	口乾
口干冒	口干冒
口干政	口干政
口干涉	口干涉
口干犯	口干犯
口干预	口干預
口燥唇干	口燥唇乾
口腹之欲	口腹之慾
口里	口裡
口钟	口鐘
古人有云	古人有云
古文里	古文裡
古书云	古書云
古書云	古書云
古柯咸	古柯鹹
古朴	古樸
古語云	古語云
古语云	古語云
古迹	古蹟
古钟	古鐘
古钟表	古鐘錶
另辟	另闢
叩钟	叩鐘
只占卜	只占卜
只占吉	只占吉
只占神问卜	只占神問卜
只占算	只占算
只影响	只影響
只影響	只影響
只采	只採
只冲	只衝
只身上已	只身上已
只身上有	只身上有
只身上沒	只身上沒
只身上没	只身上沒
只身上无	只身上無
只身上無	只身上無
只身上的	只身上的
只身世	只身世
只身份	只身份
只身前	只身前
只身受	只身受
只身子	只身子
只身形	只身形
只身影	只身影
只身后	只身後
只身後	只身後
只身心	只身心
只身旁	只身旁
只身材	只身材
只身段	只身段
只身为	只身為
只身為	只身為
只身边	只身邊
只身邊	只身邊
只身首	只身首
只身体	只身體
只身體	只身體
只身高	只身高
只采声	只采聲
叮叮当当	叮叮噹噹
叮当	叮噹
可紧可松	可緊可鬆
可能干預	可能干預
可能干预	可能干預
可自制	可自制
可鉴	可鑑
台子女	台子女
台子孙	台子孫
台州	台州
台历史	台歷史
台钟	台鐘
台风奖	台風獎
台风稳健	台風穩健
史鉴	史鑑
叶不二子	叶不二子
叶志穗	叶志穗
叶恭弘	叶恭弘
叶音	叶音
叶韵	叶韻
叶韻	叶韻
吃板刀面	吃板刀麵
吃碗面	吃碗麵
吃姜	吃薑
吃里扒外	吃裡扒外
吃里爬外	吃裡爬外
吃面	吃麵
各辟	各闢
各类钟	各類鐘
合伙人	合伙人
合并	合併
合伙	合夥
合府上	合府上
合采	合採
合历	合曆
合历史	合歷史
合准	合準
吉凶庆吊	吉凶慶弔
吉征	吉徵
吊钟	吊鐘
同人志	同人誌
同伙	同夥
同余	同餘
名单于	名單於
后冠	后冠
后北街	后北街
后土	后土
后妃	后妃
后姓	后姓
后安路	后安路
后平路	后平路
后庄	后庄
后母戊	后母戊
后海湾	后海灣
后海灣	后海灣
后瑞站	后瑞站
后稷	后稷
后綜	后綜
后羿	后羿
后翼弃兵	后翼棄兵
后翼棄兵	后翼棄兵
后苍	后蒼
后蒼	后蒼
后街	后街
后角	后角
后丰	后豐
后豐	后豐
后里	后里
后发FK型星	后髮FK型星
后髮FK型星	后髮FK型星
后发座	后髮座
后髮座	后髮座
后发星系团	后髮星系團
后髮星系團	后髮星系團
吐哺捉发	吐哺捉髮
吐哺握发	吐哺握髮
向往来	向往來
向往常	向往常
向往日	向往日
向往时	向往時
吞并	吞併
吟游	吟遊
吧台	吧檯
含齿戴发	含齒戴髮
吸干	吸乾
吹干	吹乾
吾为之范我驰驱	吾爲之範我馳驅
吕后	呂后
呂后	呂后
呆致致	呆緻緻
呆里呆气	呆裡呆氣
告札	告劄
告里	告裡
呦喂	呦喂
周后	周后
周惠后	周惠后
周历	周曆
周杰	周杰
周历史	周歷史
周游列国	周遊列國
呵喂	呵喂
呼吁	呼籲
命中注定	命中注定
和奸	和姦
和平之后	和平之后
和制汉	和製漢
和制英语	和製英語
咎征	咎徵
咕咕钟	咕咕鐘
咪表	咪錶
咬姜呷醋	咬薑呷醋
咯当	咯噹
哀吊	哀弔
哀挽	哀輓
品鉴	品鑑
哄堂大笑	哄堂大笑
哈啰喂	哈囉喂
哈囉喂	哈囉喂
員山庄	員山庄
哪里	哪裡
唁吊	唁弔
呗赞	唄讚
唇干	唇乾
唯一只	唯一只
唱游	唱遊
唾面自干	唾面自乾
唾余	唾餘
商历	商曆
商标准许	商標准許
商历史	商歷史
啊喂	啊喂
启发式	啟發式
啷当	啷噹
喂。	喂。
喂了一声	喂了一聲
喂了一聲	喂了一聲
喂喂	喂喂
喂喂喂	喂喂喂
喂哟	喂喲
喂喲	喂喲
喂！	喂！
喂，	喂，
喂？	喂？
喝干	喝乾
喧哗两成败	喧嘩兩成敗
喧哗	喧譁
喧哄	喧鬨
丧钟	喪鐘
乔岳	喬嶽
单于	單于
單于	單于
单向	單向
單向	單向
单单于	單單於
单干	單幹
单打独斗	單打獨鬥
哟喂	喲喂
喲喂	喲喂
嘉谷	嘉穀
嘴里	嘴裡
恶心	噁心
噙齿戴发	噙齒戴髮
当啷	噹啷
当当	噹噹
尝粪	嚐糞
噜苏	嚕囌
啮合	嚙合
啮齿类	嚙齒類
向导	嚮導
向往	嚮往
向慕	嚮慕
向迩	嚮邇
严云农	嚴云農
嚴云農	嚴云農
嚼谷	嚼穀
啰啰苏苏	囉囉囌囌
啰苏	囉囌
嘱托	囑託
啮虫	囓蟲
四个	四個
四出征收	四出徵收
四分历	四分曆
四分历史	四分歷史
四周后	四周後
四天后	四天後
四舍五入	四捨五入
四舍六入	四捨六入
四杆铁笔	四桿鐵筆
四扎	四紮
四只	四隻
四面包	四面包
四面钟	四面鐘
四余	四餘
回佣	回佣
回采	回採
回旋加速	回旋加速
回历	回曆
回历史	回歷史
回复中	回覆中
回复你	回覆你
回复帖子	回覆帖子
回复意见	回覆意見
回复说	回覆說
回覆通告	回覆通告
回复邮件	回覆郵件
回复：	回覆：
回游	回遊
困倦起来	困倦起來
困兽之斗	困獸之鬥
困兽犹斗	困獸猶鬥
困斗	困鬥
固定制	固定制
固征	固徵
圈里	圈裡
国之桢干	國之楨榦
国干网	國幹網
国历	國曆
国历代	國歷代
国历任	國歷任
国历来	國歷來
国历史	國歷史
国历届	國歷屆
国历经	國歷經
国仇	國讎
园里	園裡
园游会	園遊會
图里的	圖裡的
图里，	圖裡，
图鉴	圖鑑
土索面	土索麵
土里	土裡
土制	土製
在制品	在制品
在山里	在山裡
地图里	地圖裡
地心历表	地心曆表
地志	地誌
地丑德齐	地醜德齊
坐台鐵	坐台鐵
坐台铁	坐台鐵
坐如钟	坐如鐘
坐台	坐檯
坐钟	坐鐘
坑口里	坑口里
坑里	坑裡
坤范	坤範
坦荡	坦蕩
坦荡荡	坦蕩蕩
坱郁	坱鬱
垂范	垂範
垂发	垂髮
型范	型範
埃及历	埃及曆
埃及历史	埃及歷史
埃及艳后	埃及豔后
埃荣冲	埃榮衝
城市里	城市裡
城里	城裡
埔子里	埔子里
域里	域裡
基干	基幹
基准	基準
坚致	堅緻
堙淀	堙澱
堡子里	堡子里
场里	場裡
塘栖	塘栖
塞耳盗钟	塞耳盜鐘
境里	境裡
境里程	境里程
墓志铭	墓志銘
墓志	墓誌
增辟	增闢
墨子里	墨子里
墨斗	墨斗
墨沈沈	墨沈沈
墨沈	墨瀋
垦辟	墾闢
压制出	壓製出
压制机	壓製機
壮游	壯遊
壮面	壯麵
壹郁	壹鬱
壶里	壺裡
壸范	壼範
壽天里	壽天里
寿面	壽麵
夏于乔	夏于喬
夏于喬	夏于喬
夏后氏	夏后氏
夏历	夏曆
夏历史	夏歷史
夏游	夏遊
外强中干	外強中乾
外制	外製
外面包	外面包
多半只	多半只
多只包括	多只包括
多只可	多只可
多只含	多只含
多只在	多只在
多只是	多只是
多只会	多只會
多只會	多只會
多只有	多只有
多只比	多只比
多只用	多只用
多只能	多只能
多只限	多只限
多只需	多只需
多只須	多只須
多只须	多只須
多周后	多周後
多天后	多天後
多冲	多衝
多丑	多醜
多只	多隻
多余	多餘
多出电影	多齣電影
夜晚里	夜晚裡
夜里	夜裡
夜游	夜遊
梦里	夢裡
梦游	夢遊
伙伴	夥伴
伙友	夥友
伙同	夥同
伙众	夥眾
伙计	夥計
大伙儿	大伙兒
大只可	大只可
大只在	大只在
大只是	大只是
大只会	大只會
大只有	大只有
大只能	大只能
大只需	大只需
大周后	大周后
大型钟	大型鐘
大型钟表面	大型鐘表面
大型钟表	大型鐘錶
大型钟面	大型鐘面
大多只	大多只
大伙	大夥
大干一	大幹一
大批涌到	大批湧到
大折儿	大摺兒
大明历	大明曆
大明历史	大明歷史
大历	大曆
大本钟	大本鐘
大历史	大歷史
大历险	大歷險
大病初愈	大病初癒
大目干连	大目乾連
大笨钟	大笨鐘
大蜡	大蜡
大衍历	大衍曆
大衍历史	大衍歷史
大言非夸	大言非夸
大夸	大誇
大赞	大讚
大周折	大週摺
大丑	大醜
大金发苔	大金髮苔
大钟	大鐘
大只	大隻
大风后	大風後
天主之仆	天主之僕
天保历	天保曆
天克地冲	天克地衝
天台	天台
天后	天后
天后宫	天后宮
天地志狼	天地志狼
天地为范	天地為範
天后来	天後來
天后半	天後半
天后天	天後天
天文学钟	天文學鐘
天文历表	天文曆表
天文钟	天文鐘
天历	天曆
天历史	天歷史
天神之后	天神之后
天里	天裡
天里昂	天里昂
天里村	天里村
太仆	太僕
太凶	太兇
太初历	太初曆
太初历史	太初歷史
太后	太后
太丑	太醜
太阁	太閤
夸克	夸克
夸父	夸父
夸特	夸特
夸脱	夸脫
奇勋	奇勳
奇迹	奇蹟
奇丑	奇醜
奏折	奏摺
夺斗	奪鬥
奋斗	奮鬥
女丑	女丑
女仆	女僕
奴仆	奴僕
奸淫掳掠	奸淫擄掠
好家伙	好傢夥
好凶	好兇
好勇斗狠	好勇鬥狠
好斗大	好斗大
好斗室	好斗室
好斗笠	好斗笠
好斗篷	好斗篷
好斗胆	好斗膽
好斗膽	好斗膽
好斗蓬	好斗蓬
好困	好睏
好丑	好醜
好斗	好鬥
如果干	如果幹
如饥似渴	如饑似渴
妖后	妖后
妖气冲天	妖氣衝天
妆台	妝檯
姆万扎	姆萬扎
姓么	姓么
委托	委託
委托书	委託書
奸夫	姦夫
奸妇	姦婦
奸情	姦情
奸杀	姦殺
奸污	姦污
奸淫	姦淫
威棱	威稜
婢仆	婢僕
嫌凶	嫌兇
嫌好道丑	嫌好道醜
嫩姜	嫩薑
嬉游	嬉遊
嬖幸	嬖倖
嬴余	嬴餘
子之丰兮	子之丰兮
子云	子云
子里	子裡
子里甲	子里甲
字汇	字彙
字母后	字母後
字码表	字碼表
字里	字裡
存折	存摺
孛里海	孛里海
孝惠后	孝惠后
孙杰	孫杰
孫杰	孫杰
学家	學家
学里	學裡
宇宙志	宇宙誌
安沈铁路	安瀋鐵路
宋王台	宋王臺
宗周钟	宗周鐘
官不怕大只怕管	官不怕大只怕管
官地为采	官地為寀
官历	官曆
官历史	官歷史
定准	定準
定制	定製
宜云	宜云
宣泄	宣洩
宦游	宦遊
宫里	宮裡
宫斗	宮鬥
宴游	宴遊
家仆	家僕
家里	家裡
家丑	家醜
容范	容範
宿舍	宿舍
寄托在	寄托在
寄托	寄託
密致	密緻
寇准	寇準
寇仇	寇讎
富余	富餘
寒栗	寒慄
寓禁于征	寓禁於徵
寡欲	寡慾
实干	實幹
实累累	實纍纍
实验里	實驗裡
审干	審幹
写字台	寫字檯
宽余	寬餘
宽松	寬鬆
宽松松	寬鬆鬆
寮采	寮寀
寶山庄	寶山庄
宝历	寶曆
寶曆	寶曆
宝历史	寶歷史
宝里宝气	寶裡寶氣
宝鉴	寶鑑
寸发千金	寸髮千金
寺钟	寺鐘
封后	封后
封为后	封為后
封為后	封為后
封面里	封面裡
射雕	射鵰
专辑里	專輯裡
尊后	尊后
对不准	對不準
对折	對摺
对准	對準
对准表	對準錶
对准钟	對準鐘
对准钟表	對準鐘錶
對着幹	對着幹
对华发	對華發
对表中	對表中
对表扬	對表揚
对表明	對表明
对表演	對表演
对表现	對表現
对表达	對表達
导游	導遊
小丑	小丑
小井里	小井里
小价	小价
小仆	小僕
小几	小几
小只可	小只可
小只在	小只在
小只是	小只是
小只会	小只會
小只有	小只有
小只能	小只能
小只需	小只需
小周后	小周后
小型钟	小型鐘
小型钟表面	小型鐘表面
小型钟表	小型鐘錶
小型钟面	小型鐘面
小时里	小時裡
小米面	小米麵
小只	小隻
小鸟游	小鳥遊
少采	少採
就范	就範
就里	就裡
尸位素餐	尸位素餐
尸佼	尸佼
尸利	尸利
尸子	尸子
尸居余气	尸居餘氣
尸弃佛	尸棄佛
尸棄佛	尸棄佛
尸祝	尸祝
尸祿	尸祿
尸禄	尸祿
尸罗	尸羅
尸羅	尸羅
尸罗精舍	尸羅精舍
尸羅精舍	尸羅精舍
尸臣	尸臣
尸谏	尸諫
尸逐	尸逐
尸魂界	尸魂界
尸鳩	尸鳩
尸鸠	尸鳩
局促不安	局促不安
局里	局裡
屋里	屋裡
屏风后	屏風後
屡顾尔仆	屢顧爾僕
属托	屬託
屯扎	屯紮
屯里	屯裡
山仔后	山仔后
山崩钟应	山崩鐘應
山岳	山嶽
山棱	山稜
山羊胡	山羊鬍
山里有	山裡有
山里的	山裡的
山谷	山谷
山重水复	山重水複
岑子杰	岑子杰
岩松了	岩松了
岫岩	岫巖
岱岳	岱嶽
峇里海	峇里海
峰回	峰迴
峻岭	峻岭
昆剧	崑劇
昆山	崑山
昆冈	崑岡
昆仑	崑崙
昆嵛	崑嵛
昆承湖	崑承湖
昆曲	崑曲
昆玉市	崑玉市
昆腔	崑腔
昆苏	崑蘇
昆调	崑調
崖广	崖广
崖姜	崖薑
嶒棱	嶒稜
岳岳	嶽嶽
岳麓	嶽麓
巡回医疗	巡回醫療
巡回	巡迴
巡游	巡遊
工作台	工作檯
左冲右突	左衝右突
巧干	巧幹
巧历	巧曆
巧历史	巧歷史
巨制	巨製
差之毫厘	差之毫厘
己丑	己丑
已占卜	已占卜
已占算	已占算
巴尔干	巴爾幹
巴而术	巴而朮
巷里	巷裡
市里的	市裡的
布谷	布穀
布谷鸟	布穀鳥
布谷鸟钟	布穀鳥鐘
布里海	布里海
希伯来历	希伯來曆
希伯来历史	希伯來歷史
帘子	帘子
帘布	帘布
帛尸梨	帛尸梨
帝后	帝后
师范	師範
席卷	席捲
带征	帶徵
带余	帶餘
带发修行	帶髮修行
幅图里	幅圖裡
干系	干係
平平当当	平平當當
平准	平準
年代里	年代裡
年历	年曆
年历史	年歷史
年历次	年歷次
年谷	年穀
年里	年裡
年里約	年里約
年里约	年里約
年鉴	年鑑
并州	并州
并日而食	并日而食
并迭	并迭
幸运胡	幸運鬍
干上	幹上
干下去	幹下去
干不了	幹不了
干不成	幹不成
干了	幹了
干事	幹事
干些	幹些
干什么	幹什麼
干仗	幹仗
干个	幹個
干劲	幹勁
干吏	幹吏
干员	幹員
干啥	幹啥
干吗	幹嗎
干嘛	幹嘛
干坏事	幹壞事
干大事	幹大事
干完	幹完
干家	幹家
干得	幹得
干性油	幹性油
干才	幹才
干掉	幹掉
干探	幹探
干校	幹校
干活	幹活
干流	幹流
干济	幹濟
干营生	幹營生
干父之蛊	幹父之蠱
干球温度	幹球溫度
干甚么	幹甚麼
干略	幹略
干当	幹當
干的事	幹的事
干的好事	幹的好事
干细胞	幹細胞
干线	幹線
干练	幹練
干缺	幹缺
干群关系	幹群關係
干蛊	幹蠱
干警	幹警
干起来	幹起來
干路	幹路
干办	幹辦
干这	幹這
干过	幹過
干道	幹道
干部	幹部
干革命	幹革命
干头	幹頭
干么	幹麼
幽并	幽并
几个	幾個
几周后	幾周後
几天后	幾天後
几进几出	幾進幾出
几只	幾隻
几出	幾齣
广部	广部
庄內	庄內
庄内地方	庄內地方
庄司	庄司
床席	床蓆
店里	店裡
府干卿	府干卿
府干扰	府干擾
府干擾	府干擾
府干政	府干政
府干涉	府干涉
府干犯	府干犯
府干預	府干預
府干预	府干預
府干	府幹
座钟	座鐘
廍子里	廍子里
廓子里	廓子里
厨余	廚餘
厮斗	廝鬥
庙里	廟裡
废后	廢后
廢后	廢后
广征	廣徵
广舍	廣捨
广播里	廣播裡
延历	延曆
建筑前	建築前
建筑后	建築後
弄干	弄乾
弄丑	弄醜
弄脏胸	弄髒胸
弄松	弄鬆
弄鬼吊猴	弄鬼弔猴
吊卷	弔卷
吊取	弔取
吊古	弔古
吊唁	弔唁
吊问	弔問
吊喉	弔喉
吊丧	弔喪
吊喭	弔喭
吊奠	弔奠
吊孝	弔孝
吊客	弔客
吊宴	弔宴
吊影	弔影
吊恤	弔恤
吊慰	弔慰
吊扣	弔扣
吊拷	弔拷
吊撒	弔撒
吊文	弔文
吊旗	弔旗
吊民	弔民
吊祭	弔祭
吊纸	弔紙
吊者大悦	弔者大悅
吊腰撒跨	弔腰撒跨
吊脚儿事	弔腳兒事
吊膀子	弔膀子
吊词	弔詞
吊诡	弔詭
吊谎	弔謊
吊贺迎送	弔賀迎送
吊头	弔頭
吊鹤	弔鶴
引发	引發
引斗	引鬥
弘历	弘曆
弘历史	弘歷史
弱水三千只取一瓢	弱水三千只取一瓢
张三丰	張三丰
張三丰	張三丰
张勋	張勳
张杰	張杰
張杰	張杰
张柏芝	張栢芝
张乐于张徐	張樂于張徐
張樂于張徐	張樂于張徐
強制	強制
强制	強制
强制作用	強制作用
强奸	強姦
强干	強幹
别扭	彆扭
别拗	彆拗
别气	彆氣
弹子台	彈子檯
弹珠台	彈珠檯
汇刊	彙刊
汇算	彙算
汇纂	彙纂
汇辑	彙輯
形单影只	形單影隻
彭于晏	彭于晏
影后	影后
影相吊	影相弔
往复式	往復式
往日无仇	往日無讎
往里	往裡
待复	待覆
很干	很乾
很凶	很兇
很准	很準
很丑	很醜
很松	很鬆
律历志	律曆志
后印	後印
后台老板	後台老板
后天	後天
後庄	後庄
后面店	後面店
徐干	徐幹
徒杠	徒杠
徒托空言	徒託空言
得到回复	得到回覆
得力干将	得力幹將
从仆	從僕
从图里	從圖裡
从山里	從山裡
从里到外	從裡到外
从里向外	從裡向外
御岳山	御嶽山
御制	御製
复始	復始
复活节历表	復活節曆表
复苏	復甦
征令	徵令
征信	徵信
征候	徵候
征兆	徵兆
征兵	徵兵
征到	徵到
征募	徵募
征友	徵友
征召	徵召
征名责实	徵名責實
征吏	徵吏
征咎	徵咎
征启	徵啟
征地	徵地
征士	徵士
征婚	徵婚
征实	徵實
征庸	徵庸
征引	徵引
征得	徵得
征怪	徵怪
征才	徵才
征招	徵招
征收	徵收
征效	徵效
征文	徵文
征求	徵求
征状	徵狀
征用	徵用
征发	徵發
征税	徵稅
征稿	徵稿
征答	徵答
征结	徵結
征圣	徵聖
征聘	徵聘
征训	徵訓
征询	徵詢
征调	徵調
征象	徵象
征购	徵購
征迹	徵跡
征车	徵車
征辟	徵辟
征逐	徵逐
征选	徵選
征集	徵集
征风召雨	徵風召雨
征验	徵驗
心细如发	心細如髮
心系一	心繫一
心系世	心繫世
心系中	心繫中
心系五	心繫五
心系京	心繫京
心系人	心繫人
心系他	心繫他
心系伊	心繫伊
心系何	心繫何
心系你	心繫你
心系健	心繫健
心系传	心繫傳
心系全	心繫全
心系两	心繫兩
心系农	心繫农
心繫农	心繫农
心系功	心繫功
心系动	心繫動
心系募	心繫募
心系北	心繫北
心系十	心繫十
心系千	心繫千
心系南	心繫南
心系台	心繫台
心系和	心繫和
心系哪	心繫哪
心系唐	心繫唐
心系乔	心繫喬
心系嘱	心繫囑
心系四	心繫四
心系困	心繫困
心系国	心繫國
心系在	心繫在
心系地	心繫地
心系大	心繫大
心系天	心繫天
心系夫	心繫夫
心系奥	心繫奧
心系女	心繫女
心系她	心繫她
心系妻	心繫妻
心系妇	心繫婦
心系子	心繫子
心系它	心繫它
心系宣	心繫宣
心系家	心繫家
心系富	心繫富
心系小	心繫小
心系山	心繫山
心系川	心繫川
心系幼	心繫幼
心系广	心繫廣
心系彼	心繫彼
心系德	心繫德
心系您	心繫您
心系慈	心繫慈
心系我	心繫我
心系摩	心繫摩
心系故	心繫故
心系新	心繫新
心系日	心繫日
心系昌	心繫昌
心系晓	心繫曉
心系曼	心繫曼
心系东	心繫東
心系林	心繫林
心系母	心繫母
心系民	心繫民
心系江	心繫江
心系汶	心繫汶
心系沈	心繫沈
心系沙	心繫沙
心系泰	心繫泰
心系浙	心繫浙
心系港	心繫港
心系湖	心繫湖
心系澳	心繫澳
心系灾	心繫災
心系父	心繫父
心系生	心繫生
心系病	心繫病
心系百	心繫百
心系的	心繫的
心系众	心繫眾
心系社	心繫社
心系祖	心繫祖
心系神	心繫神
心系红	心繫紅
心系美	心繫美
心系群	心繫群
心系老	心繫老
心系舞	心繫舞
心系英	心繫英
心系茶	心繫茶
心系万	心繫萬
心系兰	心繫蘭
心系西	心繫西
心系贫	心繫貧
心系输	心繫輸
心系近	心繫近
心系远	心繫遠
心系选	心繫選
心系重	心繫重
心系长	心繫長
心系阮	心繫阮
心系震	心繫震
心系非	心繫非
心系风	心繫風
心系香	心繫香
心系高	心繫高
心系麦	心繫麥
心系黄	心繫黃
心脏	心臟
心脏痳痹	心臟痲痺
心荡	心蕩
心里面	心裏面
心里	心裡
心长发短	心長髮短
心余	心餘
必须	必須
忙里	忙裡
忙里偷闲	忙裡偷閒
忠人之托	忠人之托
忠仆	忠僕
快快当当	快快當當
快冲	快衝
怎么干	怎麼幹
怒气冲天	怒氣衝天
怒火冲天	怒火衝天
怒发冲冠	怒髮衝冠
怜奈	怜奈
思如泉涌	思如泉湧
急冲而下	急衝而下
性别扭曲	性別扭曲
性征	性徵
性欲	性慾
怨气冲天	怨氣衝天
怪里怪气	怪裡怪氣
怫郁	怫鬱
恂栗	恂慄
恒基	恒基
恒生	恒生
恒隆	恒隆
恕乏价催	恕乏价催
恢复	恢復
息交绝游	息交絕遊
息谷	息穀
悒郁	悒鬱
悠悠荡荡	悠悠蕩蕩
悠荡	悠蕩
悠游	悠遊
悲凄	悲悽
悲筑	悲筑
悲郁	悲鬱
悸栗	悸慄
凄厉	悽厲
凄怨	悽怨
凄惋	悽惋
凄惶	悽惶
凄恻	悽惻
凄怆	悽愴
凄惨	悽慘
凄戾	悽戾
凄然	悽然
凄美	悽美
凄苦	悽苦
凄酸	悽酸
情欲	情慾
惇朴	惇樸
惠文后	惠文后
恶仆	惡僕
恶直丑正	惡直醜正
恶斗	惡鬥
惴栗	惴慄
意大利面临	意大利面臨
意大利面臨	意大利面臨
愛河里花子	愛河里花子
爱河里花子	愛河里花子
爱困	愛睏
愿朴	愿樸
愿樸	愿樸
愿而恭	愿而恭
栗冽	慄冽
栗栗	慄慄
慈溪	慈谿
慌里慌张	慌裡慌張
惨淡	慘澹
庆吊	慶弔
庆历	慶曆
庆历史	慶歷史
欲令智昏	慾令智昏
欲壑难填	慾壑難填
欲念	慾念
欲海	慾海
欲火	慾火
欲障	慾障
忧郁	憂鬱
凭几	憑几
憑几	憑几
凭吊	憑弔
凭折	憑摺
凭准	憑準
凭借	憑藉
凭闲	憑閑
宪法里	憲法裡
恳托	懇託
懈松	懈鬆
应制得	應制得
應制得	應制得
应征	應徵
应钟	應鐘
懔栗	懍慄
懞懞懂懂	懞懞懂懂
懞直	懞直
惩忿窒欲	懲忿窒欲
怀里	懷裡
怀表	懷錶
怀钟	懷鐘
悬挂	懸掛
悬钟	懸鐘
懿范	懿範
恋恋不舍	戀戀不捨
成于思	成於思
戬谷	戩穀
战天斗地	戰天鬥地
战栗	戰慄
战斗	戰鬥
戏里	戲裡
戲院里	戲院里
戴表元	戴表元
戴发含齿	戴髮含齒
房里	房裡
所云	所云
所云云	所云云
所占卜	所占卜
所占星	所占星
所占算	所占算
所有只	所有只
所托	所託
扁拟谷盗虫	扁擬穀盜蟲
手冢治虫	手塚治虫
手塚治虫	手塚治虫
手折	手摺
手机里	手機裡
手表态	手表態
手表態	手表態
手表明	手表明
手表决	手表決
手表決	手表決
手表演	手表演
手表现	手表現
手表現	手表現
手表示	手表示
手表达	手表達
手表達	手表達
手表露	手表露
手表面	手表面
手里剑	手裏劍
手里	手裡
手游	手遊
手表	手錶
手链	手鍊
手松	手鬆
才干休	才干休
才干戈	才干戈
才干扰	才干擾
才干政	才干政
才干涉	才干涉
才干预	才干預
才干	才幹
扎好底子	扎好底子
扎好根	扎好根
扑作教刑	扑作教刑
扑打	扑打
扑挞	扑撻
扑撻	扑撻
打干哕	打乾噦
打出吊入	打出弔入
打卡钟	打卡鐘
打吨	打吨
打干	打幹
打断发	打斷發
打卤	打滷
打谷	打穀
打钟	打鐘
打风后	打風後
打斗	打鬥
托管国	托管國
扯面	扯麵
扶余	扶餘
批准	批准
批准确定	批准確定
批复	批覆
批注	批註
批斗	批鬥
抑制	抑制
抑郁	抑鬱
抓奸	抓姦
抓斗	抓斗
抗御	抗禦
折子戏	折子戲
折子戲	折子戲
折戟沈河	折戟沈河
折冲	折衝
披榛采兰	披榛採蘭
披头散发	披頭散髮
披发	披髮
抱朴而长吟兮	抱朴而長吟兮
抱素怀朴	抱素懷樸
抵御	抵禦
抹干	抹乾
抽干	抽乾
抽公签	抽公籤
抽签	抽籤
抿发	抿髮
拂钟无声	拂鐘無聲
拆伙	拆夥
拈须	拈鬚
拉克施尔德钟	拉克施爾德鐘
拉纤	拉縴
拉面上	拉面上
拉面具	拉面具
拉面前	拉面前
拉面巾	拉面巾
拉面无	拉面無
拉面皮	拉面皮
拉面罩	拉面罩
拉面色	拉面色
拉面部	拉面部
拉面	拉麵
拌面	拌麵
拓朴	拓樸
拔发	拔髮
拔须	拔鬚
拗别	拗彆
拙朴	拙樸
拚舍	拚捨
拜托	拜託
拭干	拭乾
拮据	拮据
拳局	拳跼
拼斗	拼鬥
拾沈	拾瀋
拿不准	拿不準
拿准	拿準
拿破仑	拿破崙
挌斗	挌鬥
挑斗	挑鬥
捉奸徒	捉奸徒
捉奸细	捉奸細
捉奸贼	捉奸賊
捉奸党	捉奸黨
捉奸	捉姦
捍御	捍禦
捏面人	捏麵人
舍不得	捨不得
舍入	捨入
舍出	捨出
舍去	捨去
舍命	捨命
舍堕	捨墮
舍安就危	捨安就危
舍实	捨實
舍己从人	捨己從人
舍己救人	捨己救人
舍己为人	捨己為人
舍己为公	捨己為公
舍己为国	捨己為國
舍得	捨得
舍我其谁	捨我其誰
舍本逐末	捨本逐末
舍弃	捨棄
舍死忘生	捨死忘生
舍生	捨生
舍短取长	捨短取長
舍身	捨身
舍车保帅	捨車保帥
舍近求远	捨近求遠
卷住	捲住
卷来	捲來
卷儿	捲兒
卷入	捲入
卷动	捲動
卷去	捲去
卷图	捲圖
卷土重来	捲土重來
卷地	捲地
卷尺	捲尺
卷尾猴	捲尾猴
卷心菜	捲心菜
卷成	捲成
卷曲	捲曲
卷款	捲款
卷毛	捲毛
卷烟盒	捲煙盒
卷瓣	捲瓣
卷积云	捲積雲
卷筒	捲筒
卷帘	捲簾
卷纸	捲紙
卷缩	捲縮
卷舌	捲舌
卷叶蛾	捲葉蛾
卷袖	捲袖
卷走	捲走
卷起	捲起
卷轴	捲軸
卷逃	捲逃
卷铺盖	捲鋪蓋
卷云	捲雲
卷风	捲風
卷发	捲髮
捵面	捵麵
捶炼	捶鍊
扫荡	掃蕩
授勋	授勳
授时历	授時曆
掌柜	掌柜
排干	排乾
排干部	排幹部
排骨面	排骨麵
挂名	掛名
挂历	掛曆
挂钩	掛鈎
挂面	掛麵
采下	採下
采伐	採伐
采住	採住
采信	採信
采光	採光
采到	採到
采制	採制
采区	採區
采去	採去
采取	採取
采回	採回
采在	採在
采好	採好
采得	採得
采拾	採拾
采挖	採挖
采掘	採掘
采摘	採摘
采摭	採摭
采择	採擇
采撷	採擷
采收	採收
采料	採料
采暖	採暖
采桑	採桑
采棉	採棉
采样	採樣
采樵人	採樵人
采树种	採樹種
采气	採氣
采油	採油
采为	採為
采煤	採煤
采获	採獲
采猎	採獵
采珠	採珠
采生折割	採生折割
采用	採用
采石	採石
采砂	採砂
采矿	採礦
采种	採種
采空区	採空區
采空采穗	採空採穗
采纳	採納
采给	採給
采编	採編
采花	採花
采芹人	採芹人
采茶	採茶
采菊	採菊
采莲	採蓮
采薇	採薇
采薪	採薪
采药	採藥
采血	採血
采行	採行
采补	採補
采访	採訪
采证	採證
采买	採買
采购	採購
采办	採辦
采运	採運
采过	採過
采选	採選
采金	採金
采录	採錄
采铁	採鐵
采集	採集
采风	採風
采风问俗	採風問俗
采食	採食
采盐	採鹽
掣签	掣籤
控制	控制
推情准理	推情準理
推托之词	推托之詞
推托	推託
提子干	提子乾
提心吊胆	提心弔膽
提摩太后书	提摩太後書
提高后	提高後
换只	換隻
握发	握髮
揩干	揩乾
揪采	揪採
揪发	揪髮
揪须	揪鬚
揭丑	揭醜
挥手表	揮手表
揮手表	揮手表
搋面	搋麵
搏斗	搏鬥
捣鬼吊白	搗鬼弔白
扼肮	搤肮
搤肮	搤肮
扼肮拊背	搤肮拊背
搬斗	搬鬥
搭干铺	搭乾鋪
搭伙	搭夥
抢注	搶註
摧坚获丑	摧堅獲醜
摭采	摭採
摸棱	摸稜
摸钟	摸鐘
折奏	摺奏
折子	摺子
折尺	摺尺
折扇	摺扇
折梯	摺梯
折椅	摺椅
折台	摺檯
折叠	摺疊
折痕	摺痕
折篷	摺篷
折纸	摺紙
折裙	摺裙
撇吊	撇弔
捞干	撈乾
捞面	撈麵
撚须	撚鬚
撞钟	撞鐘
撞阵冲军	撞陣衝軍
撤并	撤併
拨谷	撥穀
撩斗	撩鬥
扑冬	撲鼕
扑咚	撲鼕
扑咚咚	撲鼕鼕
擀面	擀麵
击扑	擊扑
擊扑	擊扑
击钟	擊鐘
操作钟	操作鐘
担仔面	擔仔麵
担担面	擔擔麵
据云	據云
擢发	擢髮
擦干	擦乾
拧干	擰乾
摆钟	擺鐘
摄制	攝製
支干	支幹
支配欲	支配慾
收回	收回
收获	收穫
改制成	改制成
改征	改徵
改采	改採
放懞挣	放懞掙
放荡	放蕩
放松	放鬆
政斗	政鬥
故云	故云
教学钟	教學鐘
教范	教範
敢干、	敢幹、
敢干的	敢幹的
敢干，	敢幹，
敢情欲	敢情欲
散伙	散夥
散荡	散蕩
敦朴	敦樸
敬挽	敬輓
敲扑	敲扑
敲钟	敲鐘
整只	整隻
整风后	整風後
整发用品	整髮用品
整出剧	整齣劇
整出戏	整齣戲
整出电影	整齣電影
敌忾同仇	敵愾同讎
数只包括	數只包括
数只可	數只可
数只含	數只含
数只在	數只在
数只应	數只應
数只是	數只是
数只会	數只會
数只有	數只有
数只比	數只比
数只能	數只能
数只限	數只限
数只需	數只需
数只须	數只須
数天后	數天後
数字钟	數字鐘
数字钟表	數字鐘錶
数罪并罚	數罪併罰
数只	數隻
文丑	文丑
文学志	文學誌
文征明	文徵明
文思泉涌	文思泉湧
文杰	文杰
文采郁郁	文采郁郁
斗法会	斗法會
斗牛星	斗牛星
斫雕为朴	斫雕為樸
新井里美	新井里美
新干县	新幹縣
新庄子	新庄子
新历	新曆
新历史	新歷史
新扎	新紮
斲雕为朴	斲雕為樸
断发现	斷發現
断发	斷髮
断发文身	斷髮文身
方便面	方便麵
方向	方向
方法里	方法裡
于吉林	於吉林
于吉尔吉斯	於吉爾吉斯
于吉隆坡	於吉隆坡
于敏感	於敏感
于格林	於格林
于格陵兰	於格陵蘭
于格鲁	於格魯
于波特	於波特
于禁止	於禁止
于越南	於越南
于越过	於越過
于震中	於震中
于震前	於震前
于震区	於震區
于震度	於震度
于震后	於震後
于震灾	於震災
施舍	施捨
施舍之道	施舍之道
旁征博引	旁徵博引
旁注	旁註
旅游	旅遊
旋回	旋迴
旋松	旋鬆
族里	族裡
日心历表	日心曆表
日历	日曆
日历史	日歷史
日里	日裡
日志	日誌
旱干	旱乾
升州	昇州
升平	昇平
升阳	昇陽
昊天不吊	昊天不弔
明征	明徵
明目张胆	明目張胆
明窗净几	明窗淨几
明范	明範
明鉴	明鑑
昔人有云	昔人有云
星历	星曆
星期后	星期後
星历史	星歷史
星露谷物语	星露谷物語
春游	春遊
春香斗学	春香鬥學
昭惠后	昭惠后
是发小	是髮小
时代里	時代裡
时钟	時鐘
时间不准	時間不準
晃荡	晃蕩
晚钟	晚鐘
晞发	晞髮
晨钟	晨鐘
普咚咚	普鼕鼕
晾干	晾乾
暗地里	暗地裡
暗沟里	暗溝裡
暗里	暗裡
暗斗	暗鬥
畅游	暢遊
昵称	暱稱
暴敛横征	暴斂橫徵
历元	曆元
历命	曆命
历始	曆始
历室	曆室
历尾	曆尾
历局	曆局
历数书	曆數書
历日	曆日
历书	曆書
历本	曆本
历法	曆法
历狱	曆獄
历纪	曆紀
历象	曆象
晒干	曬乾
晒谷	曬穀
曰云	曰云
更仆难数	更僕難數
更钟情	更鍾情
更钟意	更鍾意
更钟爱	更鍾愛
更钟	更鐘
书签	書籤
书面	書面
曹子里	曹子里
曹廷杰	曹廷杰
曼谷	曼谷
曾朴	曾樸
最多	最多
最多只	最多只
会干扰	會干擾
會干擾	會干擾
会干	會幹
会吊	會弔
会里	會裡
月历	月曆
月历史	月歷史
月球历表	月球曆表
月里来	月裡來
月面	月面
有事之无范	有事之無範
有仆	有僕
有只不	有只不
有只允	有只允
有只容	有只容
有只採	有只採
有只采	有只採
有只是	有只是
有只用	有只用
有只能	有只能
有回复	有回覆
有够赞	有夠讚
有征伐	有征伐
有征战	有征戰
有征戰	有征戰
有征服	有征服
有征討	有征討
有征讨	有征討
有征	有徵
有恒街	有恒街
有栖	有栖
有准	有準
有棱有角	有稜有角
有只	有隻
有余	有餘
有发头陀寺	有髮頭陀寺
望了望	望了望
望后石	望后石
朝钟	朝鐘
朝鲜于	朝鮮於
朦胧	朦朧
蒙胧	朦朧
木偶戏扎	木偶戲紮
木材干馏	木材乾餾
木梁	木樑
木签	木籤
木制	木製
木钟	木鐘
未干	未乾
未干涉	未干涉
未干預	未干預
未干预	未干預
本庄	本庄
本征	本徵
本出戏	本齣戲
术忽	朮忽
术虎高	朮虎高
术赤	朮赤
朱庆余	朱慶餘
朱理安历	朱理安曆
朱理安历史	朱理安歷史
朴子里	朴子里
李志喜	李志喜
李适	李适
李连杰	李連杰
李連杰	李連杰
材干	材幹
村落发	村落發
村里有	村裡有
村里的	村裡的
杜琪峰	杜琪峯
杜老志道	杜老誌道
杞宋无征	杞宋無徵
束发	束髮
杠人	杠人
杠梁	杠梁
杠毂	杠轂
杠轂	杠轂
杯干	杯乾
杯面	杯麵
杰伦	杰倫
杰倫	杰倫
杰威尔	杰威爾
杰威爾	杰威爾
东周钟	東周鐘
东岳	東嶽
東湖里	東湖里
东冲西突	東衝西突
东游	東遊
松口蘑	松口蘑
松口镇	松口鎮
松山庄	松山庄
松溪县	松谿縣
松开始	松開始
板荡	板蕩
林宏岳	林宏嶽
林杰樑	林杰樑
林郁方	林郁方
林钟	林鐘
林鹅峰	林鵞峰
果干	果乾
果子干	果子乾
果累累	果纍纍
枝干	枝幹
枯干	枯乾
架钟	架鐘
某只	某隻
染殿后	染殿后
染发生	染發生
染发	染髮
柜上	柜上
柜子	柜子
柜柳	柜柳
查封后	查封後
柳斌杰	柳斌杰
柳诒征	柳詒徵
栗栖	栗栖
校准	校準
校舍	校舍
核准	核准
格范	格範
格里历	格里曆
格里高利历	格里高利曆
格斗	格鬥
桂圆干	桂圓乾
框里	框裡
桌几	桌几
桌历	桌曆
桌历史	桌歷史
桌游	桌遊
桑干	桑乾
杆枪	桿槍
杆秤	桿秤
杆菌	桿菌
梁凌杰	梁凌杰
梁启超	梁啓超
条文里	條文裡
梨干	梨乾
梯冲	梯衝
械系	械繫
械斗	械鬥
弃舍	棄捨
棉里	棉裡
棉制	棉製
棒子面	棒子麵
棫朴	棫樸
森林里	森林裡
棺材里	棺材裡
植发	植髮
椒面	椒麵
椰枣干	椰棗乾
杨雅筑	楊雅筑
楊雅筑	楊雅筑
桢干	楨幹
业余	業餘
榨干	榨乾
枪杆	槍桿
杠杆	槓桿
乐器钟	樂器鐘
乐游原	樂遊原
樗里子	樗里子
标标致致	標標致致
标准	標準
标签	標籤
标致	標緻
标注	標註
标志	標誌
模棱	模稜
模范	模範
模范七棒	模范七棒
模范三军	模范三軍
模范三軍	模范三軍
模范棒棒堂	模范棒棒堂
模制	模製
样范	樣範
樵采	樵採
朴修斯	樸修斯
朴厚	樸厚
朴学	樸學
朴实	樸實
朴念仁	樸念仁
朴拙	樸拙
朴樕	樸樕
朴父	樸父
朴直	樸直
朴素	樸素
朴茨茅斯	樸茨茅斯
朴讷	樸訥
朴质	樸質
朴鄙	樸鄙
朴重	樸重
朴野	樸野
朴钝	樸鈍
朴陋	樸陋
朴马	樸馬
朴鲁	樸魯
树干	樹幹
树林里	樹林裡
机械系	機械系
機械系	機械系
机械表	機械錶
机械钟	機械鐘
机械钟表	機械鐘錶
横亘	橫亙
横峰县	橫峯縣
横征暴敛	橫徵暴斂
横冲	橫衝
台历	檯曆
台灯	檯燈
台面上	檯面上
台面化	檯面化
柜台	櫃檯
柜里	櫃裡
栉发工	櫛髮工
权斗	權鬥
欲海难填	欲海難填
欺蒙	欺矇
歌后	歌后
歌钟	歌鐘
欧游	歐遊
正官庄	正官庄
正文里	正文裡
正杰	正杰
武丑	武丑
武后	武后
武斗	武鬥
岁聿云暮	歲聿云暮
歲聿云暮	歲聿云暮
历史里	歷史裡
归并	歸併
归余	歸餘
歹斗	歹鬥
死里求生	死裡求生
死里逃生	死裡逃生
殖谷	殖穀
残余	殘餘
僵尸	殭屍
殷师牛斗	殷師牛鬥
殷鉴	殷鑑
壳里	殼裡
殿里	殿裡
殿钟自鸣	殿鐘自鳴
毁钟为铎	毀鐘為鐸
殴斗	毆鬥
母后	母后
母范	母範
母丑	母醜
每每只	每每只
每只	每隻
毗婆尸佛	毗婆尸佛
毛坏	毛坏
毛姜	毛薑
毛发	毛髮
毫厘	毫釐
毫发	毫髮
气冲斗牛	氣沖斗牛
气郁	氣鬱
氤郁	氤鬱
水并流	水併流
水来汤里去	水來湯裡去
水准	水準
水表示	水表示
水表面	水表面
水里	水裡
水里商工	水里商工
水里溪	水里溪
水里濁水溪	水里濁水溪
水里鄉	水里鄉
水里高級商工	水里高級商工
水里鳳林	水里鳳林
水表	水錶
永历	永曆
永历史	永歷史
永志不忘	永誌不忘
求知欲	求知慾
求签	求籤
江并流	江併流
池里	池裡
污蔑	污衊
汤卤	汤滷
汤滷	汤滷
决斗	決鬥
沈淀	沈澱
沈郁	沈鬱
沉淀	沉澱
沉郁	沉鬱
没干没净	沒乾沒淨
没事干	沒事幹
没干	沒幹
没折至	沒摺至
没样范	沒樣範
没准	沒準
冲冠发怒	沖冠髮怒
冲天	沖天
沙坪坝	沙坪垻
沙琅	沙瑯
沙羡	沙羡
沙里淘金	沙裡淘金
河岳	河嶽
河里	河裡
油泼面	油潑麵
油斗	油鬥
油面	油麵
治愈	治癒
沿溯	沿泝
法自制	法自制
法里，	法裡，
泛游	泛遊
泡制	泡製
泡面	泡麵
波棱菜	波稜菜
波发藻	波髮藻
注云	注云
注释	注釋
泱郁	泱鬱
泳气钟	泳氣鐘
洋河大曲	洋河大麯
洒家	洒家
洒淅	洒淅
洒濯	洒濯
洒然	洒然
洗炼	洗鍊
洗练	洗鍊
洗发	洗髮
洛钟东应	洛鐘東應
洞里	洞裡
洞里萨	洞里薩
洞里薩	洞里薩
泄欲	洩慾
洪范	洪範
洪谷子	洪谷子
洪适	洪适
洪钟	洪鐘
汹涌	洶湧
流征	流徵
流荡	流蕩
流风余俗	流風餘俗
流风余韵	流風餘韻
浩浩荡荡	浩浩蕩蕩
浩荡	浩蕩
浪荡	浪蕩
浪游	浪遊
浮荡	浮蕩
浮夸	浮誇
浮松	浮鬆
海干	海乾
海淀山后	海淀山後
海淀山後	海淀山後
浸卤	浸滷
涂善妮	涂善妮
涂坤	涂坤
涂壮勋	涂壯勳
涂壯勳	涂壯勳
涂天相	涂天相
涂姓	涂姓
涂序瑄	涂序瑄
涂敏恆	涂敏恆
涂敏恒	涂敏恆
涂泽民	涂澤民
涂澤民	涂澤民
涂尔干	涂爾幹
涂爾幹	涂爾幹
涂紹煃	涂紹煃
涂绍煃	涂紹煃
涂羽卿	涂羽卿
涂謹申	涂謹申
涂谨申	涂謹申
涂逢年	涂逢年
涂醒哲	涂醒哲
涂長望	涂長望
涂长望	涂長望
涂鴻欽	涂鴻欽
涂鸿钦	涂鴻欽
涌水塘	涌水塘
涳蒙	涳濛
涸干	涸乾
凉席	涼蓆
凉面	涼麵
淋余土	淋餘土
淑范	淑範
泪干	淚乾
泪如泉涌	淚如泉湧
淡蒙蒙	淡濛濛
净余	淨餘
净发	淨髮
淫欲	淫慾
淫荡	淫蕩
淬炼	淬鍊
深山何处钟	深山何處鐘
深山里	深山裡
淳于	淳于
淳朴	淳樸
渊淳岳峙	淵淳嶽峙
渊里	淵裡
浅淀	淺澱
清心寡欲	清心寡欲
渠冲	渠衝
温岚	温嵐
温嵐	温嵐
测不准	測不準
港制度	港制度
港制	港製
游离	游離
浑朴	渾樸
浑个	渾箇
湖南岳阳	湖南岳陽
湖里	湖裡
湖里区	湖里區
湘累	湘纍
涌上	湧上
涌来	湧來
涌入	湧入
涌出	湧出
涌向	湧向
涌水	湧水
涌泉	湧泉
涌现	湧現
涌起	湧起
涌进	湧進
湮郁	湮鬱
汤下面	湯下麵
汤团	湯糰
汤面	湯麵
准不准	準不準
准例	準例
准保	準保
准备	準備
准儿	準兒
准分子	準分子
准则	準則
准噶尔	準噶爾
准定	準定
准平原	準平原
准度	準度
准式	準式
准拿督	準拿督
准据	準據
准拟	準擬
准新娘	準新娘
准新郎	準新郎
准星	準星
准是	準是
准时	準時
准会	準會
准格尔	準格爾
准决赛	準決賽
准的	準的
准直	準直
准确	準確
准线	準線
准绳	準繩
准话	準話
准谱	準譜
准货币	準貨幣
准军事	準軍事
准头	準頭
准点	準點
沟大曲	溝大麯
沟谷	溝谷
溟蒙	溟濛
温洛克期	溫洛克期
溲面	溲麵
滃郁	滃鬱
滑借	滑藉
汇丰	滙豐
渗漓	滲灕
卤了	滷了
卤五花	滷五花
卤味	滷味
卤好	滷好
卤子	滷子
卤料	滷料
卤水	滷水
卤汁	滷汁
卤湖	滷湖
卤煮	滷煮
卤牛	滷牛
卤的	滷的
卤肉	滷肉
卤菜	滷菜
卤蛋	滷蛋
卤虾	滷蝦
卤制	滷製
卤豆	滷豆
卤鸡	滷雞
卤鸭	滷鴨
卤鹅	滷鵝
卤面	滷麵
满满当当	滿滿當當
满头洋发	滿頭洋髮
漂荡	漂蕩
漕挽	漕輓
沤郁	漚鬱
漠里	漠裡
汉弥登钟	漢彌登鐘
漫卷	漫捲
漫游	漫遊
潜意识里	潛意識裡
潜水表	潛水錶
潜水钟	潛水鐘
潜水钟表	潛水鐘錶
潭里	潭裡
潮涌	潮湧
涩谷区	澀谷區
澄江县	澂江縣
澄澹精致	澄澹精致
澒蒙	澒濛
淀山	澱山
淀浦	澱浦
淀淀	澱澱
淀积	澱積
淀粉	澱粉
淀解物	澱解物
淀谓之滓	澱謂之滓
澹台	澹臺
澹荡	澹蕩
激斗	激鬥
浓发	濃髮
蒙汜	濛汜
蒙蒙细雨	濛濛細雨
蒙雾	濛霧
蒙松雨	濛鬆雨
蒙鸿	濛鴻
浚州	濬州
浚县	濬縣
滨田里佳子	濱田里佳子
沈丹客运	瀋丹客運
沈丹线	瀋丹線
沈丹铁路	瀋丹鐵路
沈丹高	瀋丹高
沈北	瀋北
沈吉	瀋吉
沈大线	瀋大線
沈大铁路	瀋大鐵路
沈大高速	瀋大高速
沈山线	瀋山線
沈山铁路	瀋山鐵路
沈州	瀋州
沈抚	瀋撫
沈水	瀋水
沈河	瀋河
沈海铁路	瀋海鐵路
沈海高速	瀋海高速
沈阳	瀋陽
泸州大曲	瀘州大麯
沥干	瀝乾
弥山遍野	瀰山遍野
弥漫	瀰漫
弥弥	瀰瀰
漓水	灕水
漓江	灕江
漓湘	灕湘
漓然	灕然
滩涂	灘涂
灘涂	灘涂
滩席	灘蓆
火并非	火並非
火并	火併
火山里	火山裡
火折子	火摺子
火签	火籤
灰蒙	灰濛
灰蒙蒙	灰濛濛
炆面	炆麵
炒面	炒麵
炮制	炮製
炸酱面	炸醬麵
为帝后，	為帝後，
为准	為準
为鉴	為鑑
乌兹冲锋枪	烏茲衝鋒槍
乌苏里	烏蘇里
乌发	烏髮
乌龙面	烏龍麵
烘干	烘乾
烘制	烘製
烤干	烤乾
烤卤	烤滷
烹制	烹製
焙干	焙乾
无征不信	無徵不信
无业游民	無業游民
无余	無餘
炼制	煉製
煎面	煎麵
烟台	煙臺
照入签	照入籤
照相干片	照相乾片
煨干	煨乾
煮制	煮製
煮面	煮麵
熊杰	熊杰
荧郁	熒鬱
熬制	熬製
炖制	燉製
燎发	燎髮
烧干	燒乾
燕几	燕几
燕游	燕遊
烫一个发	燙一個髮
烫一次发	燙一次髮
烫个发	燙個髮
烫完发	燙完髮
烫次发	燙次髮
烫发	燙髮
烫面	燙麵
营干	營幹
烩面	燴麵
烬余	燼餘
爆发	爆發
争奇斗妍	爭奇鬥妍
争奇斗异	爭奇鬥異
争奇斗艳	爭奇鬥豔
争妍斗奇	爭妍鬥奇
争妍斗艳	爭妍鬥豔
争红斗紫	爭紅鬥紫
争斗	爭鬥
爰定祥历	爰定祥厤
爽荡	爽蕩
尔冬升	爾冬陞
墙里	牆裡
片里	片裡
片言只语	片言隻語
版图里	版圖裡
版本里	版本裡
牙签	牙籤
牛街庄	牛街莊
牛只	牛隻
牢里	牢裡
物欲	物慾
抵牾	牴牾
抵触	牴觸
特别致	特别致
特制住	特制住
特制定	特制定
特制止	特制止
特制订	特制訂
特征	特徵
特制	特製
牵一发	牽一髮
牵系	牽繫
犖确	犖确
荦确	犖确
狂并潮	狂併潮
狄志杰	狄志杰
狄那里克	狄那里克
狐借虎威	狐藉虎威
猛冲	猛衝
猜三划五	猜三划五
狱里	獄裡
奖杯	獎盃
独裁制	獨裁制
獨裁制	獨裁制
独辟蹊径	獨闢蹊徑
获匪其丑	獲匪其醜
兽欲	獸慾
献丑	獻醜
玉历	玉曆
玉历史	玉歷史
玉米面	玉米面
王侯后	王侯后
王后	王后
王添灯	王添灯
王田里	王田里
王鉴	王鑑
王余鱼	王餘魚
珍肴	珍餚
班里	班裡
球台	球檯
理一个发	理一個髮
理一次发	理一次髮
理个发	理個髮
理完发	理完髮
理次发	理次髮
理发动	理發動
理发展	理發展
理发放	理發放
理发现	理發現
理发生	理發生
理发表	理發表
理发	理髮
琴钟	琴鐘
珐琅	琺瑯
瑞城里	瑞城里
瑞征	瑞徵
瑶签	瑤籤
环游	環遊
瓷制	瓷製
甄后	甄后
瓮安	甕安
甜、咸	甜、鹹
甜水面	甜水麵
甜咸	甜鹹
甜面酱	甜麵醬
生力面	生力麵
生物钟	生物鐘
生华发	生華髮
生姜	生薑
生发剂	生髮劑
生发水	生髮水
生发油	生髮油
生发液	生髮液
生发药	生髮藥
苏醒	甦醒
用法里	用法裡
甩发	甩髮
田子里	田子里
田庄英雄	田庄英雄
田里	田裡
田里穗	田里穗
由余	由余
甲胄	甲冑
甲后路	甲后路
男仆	男僕
界里	界裡
留发展	留發展
留发生	留發生
留发行	留發行
留长发	留長髮
留发	留髮
画里	畫裡
当准	當準
当当丁丁	當當丁丁
当当网	當當網
叠席	疊蓆
疏松	疏鬆
疑凶	疑兇
疲困	疲睏
病征	病徵
病愈	病癒
病余	病餘
痊愈	痊癒
痒疹	痒疹
痒痒	痒痒
痳木	痳木
痳疹	痳疹
痳病	痳病
痳痹	痳痺
痳疯	痳瘋
愈合	癒合
症结	癥結
癸丑	癸丑
发干	發乾
发状态	發狀態
发状况	發狀況
发签	發籤
发表	發表
发松	發鬆
发面	發麵
白干儿	白乾兒
白术	白朮
白朴	白樸
白净面皮	白淨面皮
白发其事	白發其事
白皮松	白皮松
白粉面	白粉麵
白里透红	白裡透紅
白面包青天	白面包青天
白发	白髮
白霉	白黴
百个	百個
百只可	百只可
百只够	百只夠
百只夠	百只夠
百只怕	百只怕
百只足够	百只足夠
百只足夠	百只足夠
百周后	百周後
百天后	百天後
百子里	百子里
百拙千丑	百拙千醜
百科里	百科裡
百谷	百穀
百扎	百紮
百花历	百花曆
百花历史	百花歷史
百炼	百鍊
百只	百隻
百余	百餘
的回复	的回覆
的图里	的圖裡
的山里	的山裡
的干将	的幹將
的个中	的箇中
的钟	的鐘
的长发	的長髮
的发小	的髮小
皆可作淀	皆可作澱
皆准	皆準
皇后	皇后
皇历	皇曆
皇极历	皇極曆
皇极历史	皇極歷史
皇历史	皇歷史
皓发	皓髮
皮制服	皮制服
皮托管	皮托管
皮肤	皮膚
皮里春秋	皮裡春秋
皮里阳秋	皮裡陽秋
皮制	皮製
皮松	皮鬆
皱折	皺摺
盆吊	盆弔
盈余	盈餘
盒里	盒裡
盛赞	盛讚
盗采	盜採
盗钟	盜鐘
监制	監製
盘里	盤裡
盘回	盤迴
卢棱伽	盧稜伽
荡气回肠	盪氣迴腸
盲干	盲幹
直冲	直衝
相并	相併
相克制	相克制
相克服	相克服
相克	相剋
相干	相干
相冲	相衝
相斗	相鬥
盼复	盼覆
看法里	看法裡
看准	看準
看钟	看鐘
真凶	真兇
真个	真箇
真丑	真醜
眼干	眼乾
眼帘	眼帘
眼眶里	眼眶裡
眼睛里	眼睛裡
眼里	眼裡
困乏	睏乏
困倦	睏倦
困觉	睏覺
睡游病	睡遊病
瞄准	瞄準
瞎蒙	瞎矇
了望	瞭望
了然	瞭然
了若指掌	瞭若指掌
瞳蒙	瞳矇
蒙事	矇事
蒙昧无知	矇昧無知
蒙混	矇混
蒙瞍	矇瞍
蒙眬	矇矓
蒙聩	矇聵
蒙头转	矇頭轉
蒙骗	矇騙
瞩托	矚託
矜夸	矜誇
短发生	短發生
短发	短髮
短须	短鬚
矮几	矮几
石几	石几
石杠	石杠
石梁	石樑
石英钟	石英鐘
石英钟表	石英鐘錶
石钟	石鐘
研制	研製
砰当	砰噹
破鉴	破鑑
朱卷	硃卷
朱批	硃批
朱砂	硃砂
朱笔	硃筆
朱谕	硃諭
硬干	硬幹
确瘠	确瘠
碑志	碑誌
碗里	碗裡
碧河里	碧河里
碰钟	碰鐘
确系	確係
码码表	碼碼表
码表示	碼表示
码表	碼錶
磁制	磁製
磨蝎	磨蝎
磨制	磨製
磨炼	磨鍊
磨面	磨麵
磬钟	磬鐘
硗确	磽确
磽确	磽确
砻谷	礱穀
示范	示範
社里	社裡
祝赞	祝讚
祝发	祝髮
神奈川冲浪里	神奈川沖浪裏
神荼郁垒	神荼鬱壘
神游	神遊
神雕像	神雕像
神雕	神鵰
祭吊	祭弔
禁欲	禁慾
禁欲主义	禁欲主義
御侮	禦侮
御寇	禦寇
御寒	禦寒
御敌	禦敵
礼赞	禮讚
禾谷	禾穀
秃妃之发	禿妃之髮
秃发	禿髮
秀发动	秀發動
秀发展	秀發展
秀发布	秀發布
秀发村	秀發村
秀发现	秀發現
秀发生	秀發生
秀发表	秀發表
秀发起	秀發起
秀发	秀髮
私下里	私下裡
私欲	私慾
私斗	私鬥
秋游	秋遊
种丹妮	种丹妮
种师中	种師中
种師中	种師中
种师道	种師道
种師道	种師道
种放	种放
科尼亚克期	科尼亞克期
科斗	科斗
科范	科範
秒表明	秒表明
秒表示	秒表示
秒钟	秒鐘
秤杆	秤桿
秦沈客运	秦瀋客運
稀松	稀鬆
程十发	程十髮
棱台	稜台
棱子	稜子
棱层	稜層
棱柱	稜柱
棱登	稜登
棱棱	稜稜
棱等登	稜等登
棱线	稜線
棱缝	稜縫
棱角	稜角
棱锥	稜錐
棱镜	稜鏡
棱体	稜體
种谷	種穀
称帝后	稱帝後
称赞	稱讚
稻谷	稻穀
稽征	稽徵
谷保家商	穀保家商
谷仓	穀倉
谷圭	穀圭
谷城县	穀城縣
谷场	穀場
谷子	穀子
谷日	穀日
谷旦	穀旦
谷梁	穀梁
谷壳	穀殼
谷氨	穀氨
谷物	穀物
谷皮	穀皮
谷神	穀神
谷禄	穀祿
谷米	穀米
谷粒	穀粒
谷精草	穀精草
谷胱	穀胱
谷舱	穀艙
谷苗	穀苗
谷茬	穀茬
谷草	穀草
谷贵饿农	穀貴餓農
谷贱伤农	穀賤傷農
谷雨	穀雨
谷类	穀類
谷食	穀食
谷饶	穀饒
穆棱	穆稜
穆罕默德历	穆罕默德曆
穆罕默德历史	穆罕默德歷史
积淀	積澱
积谷	積穀
积谷防饥	積穀防饑
积郁	積鬱
稳健的台风	穩健的台風
稳扎	穩紮
空蒙	空濛
空荡	空蕩
空荡荡	空蕩蕩
空里	空裡
空钟	空鐘
空余	空餘
窒欲	窒慾
窗明几亮	窗明几亮
窗明几净	窗明几淨
窗帘	窗簾
窝里	窩裡
窝里斗	窩裡鬥
穷追不舍	窮追不捨
穷发	窮髮
窃钟掩耳	竊鐘掩耳
立范	立範
童仆	童僕
竞斗	競鬥
竹几	竹几
竹林之游	竹林之遊
竹签	竹籤
竹席	竹蓆
竹制	竹製
竹溪县	竹谿縣
笑里藏刀	笑裡藏刀
笔杆	筆桿
笔秃墨干	筆禿墨乾
笋干	筍乾
筑前	筑前
筑北	筑北
筑州	筑州
筑后	筑後
筑後	筑後
筑波	筑波
筑紫	筑紫
筑肥	筑肥
筑西	筑西
筑邦	筑邦
筑阳	筑陽
筑陽	筑陽
答复	答覆
筵几	筵几
个中原因	箇中原因
个中奥	箇中奧
个中好手	箇中好手
个中强手	箇中強手
个中滋味	箇中滋味
个中玄机	箇中玄機
个中理由	箇中理由
个中翘楚	箇中翹楚
个中道理	箇中道理
个中高手	箇中高手
个旧市	箇舊市
算历	算曆
算历史	算歷史
算准	算準
管制	管制
管干	管幹
箱里	箱裡
节欲	節慾
节目里	節目裡
节余	節餘
范亭	範亭
范例	範例
范围	範圍
范字	範字
范式	範式
范性形变	範性形變
范数	範數
范文	範文
范本	範本
范畴	範疇
范金	範金
简并	簡併
简朴	簡樸
简短发	簡短發
簸荡	簸蕩
签幐	籤幐
签押	籤押
签条	籤條
签诗	籤詩
吁天	籲天
吁求	籲求
吁请	籲請
米哈游	米哈遊
米沈	米瀋
米团	米糰
米余	米餘
米面	米麵
粗制	粗製
精制伏	精制伏
精制住	精制住
精制服	精制服
精干	精幹
精准	精準
精致	精緻
精制	精製
精辟	精闢
精松	精鬆
糊里糊涂	糊裡糊塗
糕干	糕乾
粪秽蔑面	糞穢衊面
团子	糰子
系列里	系列裡
系指的	系指的
系里	系裡
纪历	紀曆
纪历史	紀歷史
紅后假說	紅后假說
红后假说	紅后假說
红绳系足	紅繩繫足
红钟	紅鐘
红发	紅髮
纡回	紆迴
纡余	紆餘
纡郁	紆鬱
纳征	納徵
纯朴	純樸
纸扎	紙紮
素数里	素數裡
素朴	素樸
素发现	素發現
素发生	素發生
素发电	素發電
素发	素髮
索面	索麵
紫姜	紫薑
扎上	紮上
扎下	紮下
扎囮	紮囮
扎好	紮好
扎实	紮實
扎寨	紮寨
扎带子	紮帶子
扎成	紮成
扎根	紮根
扎营	紮營
扎紧	紮緊
扎脚	紮腳
扎裹	紮裹
扎诈	紮詐
扎起	紮起
扎铁	紮鐵
细不容发	細不容髮
细如发	細如髮
细致	細緻
细炼	細鍊
组里	組裡
结伴同游	結伴同遊
结伙	結夥
结发育	結發育
结发表	結發表
结扎	結紮
结余	結餘
结发	結髮
绞干	絞乾
络腮胡	絡腮鬍
丝恩发怨	絲恩髮怨
丝发现	絲發現
丝发生	絲發生
丝制	絲製
丝发	絲髮
绑扎	綁紮
绥棱	綏稜
捆扎	綑紮
经文里	經文裡
經有云	經有云
经有云	經有云
绿发	綠髮
维系统	維系統
维系	維繫
绾发	綰髮
纲鉴	綱鑑
網球台	網球台
网球台	網球台
网站里	網站裡
网里	網裡
网志	網誌
网游	網遊
绵亘	綿亙
紧致	緊緻
紧追不舍	緊追不捨
绪余	緒餘
线图里	線圖裡
缉凶	緝兇
编制法	編制法
编采	編採
编码表	編碼表
编钟	編鐘
编余	編餘
缓征	緩徵
缓冲	緩衝
致密	緻密
萦回	縈迴
缜致	縝緻
县里	縣裡
县志	縣誌
缝里	縫裡
缝制	縫製
缩栗	縮慄
缩短发	縮短發
纵欲	縱慾
纤夫	縴夫
纤手	縴手
纤绳	縴繩
总数只	總數只
总数里	總數裡
总裁制	總裁制
總裁制	總裁制
繁复	繁複
繁钟	繁鐘
绷扒吊拷	繃扒弔拷
绘制	繪製
系上。	繫上。
系上了	繫上了
系上安全	繫上安全
系上红	繫上紅
系上丝	繫上絲
系上绳	繫上繩
系上头	繫上頭
系上黑	繫上黑
系上，	繫上，
系到	繫到
系囚	繫囚
系心	繫心
系念	繫念
系怀	繫懷
系恋	繫戀
系于	繫於
系于一发	繫於一髮
繫着	繫着
系结	繫結
系紧	繫緊
系绳	繫繩
系累	繫纍
系膜	繫膜
系舟	繫舟
系船	繫船
系辞	繫辭
系鞋带	繫鞋帶
系风捕影	繫風捕影
累囚	纍囚
累堆	纍堆
累瓦结绳	纍瓦結繩
累绁	纍紲
累臣	纍臣
缠斗	纏鬥
坛子	罈子
坛坛罐罐	罈罈罐罐
坛𬴃	罈騞
置言成范	置言成範
罗马历	羅馬曆
罗马历代	羅馬歷代
罗马历史	羅馬歷史
羁系	羈繫
美容美发	美容美髮
美丑	美醜
美发学	美髮學
美发师	美髮師
美发店	美髮店
美发业	美髮業
美发沙龙	美髮沙龍
美发馆	美髮館
群丑	群醜
羡余	羨餘
义仆	義僕
義联	義联
翁子里	翁子里
翕辟	翕闢
翱游	翱遊
翻涌	翻湧
翻松	翻鬆
老么	老么
老干	老乾
老仆	老僕
老干部	老幹部
老懞	老懞
老爷钟	老爺鐘
老白干	老白乾
老坛	老罈
老姜	老薑
老板	老闆
老面皮	老面皮
考征	考徵
考试制度	考試制度
耍斗	耍鬥
耕获	耕穫
耳余	耳餘
耶律术烈	耶律朮烈
聊斋志异	聊齋志異
圣人历	聖人曆
圣后	聖后
聖后	聖后
圣马尔谷日	聖馬爾谷日
聖馬爾谷日	聖馬爾谷日
聘雇	聘僱
聚药雄蕊	聚葯雄蕊
闻风后	聞風後
联系	聯繫
声母后	聲母後
肉干	肉乾
肉欲	肉慾
肉丝面	肉絲麵
肉羹面	肉羹麵
肉松	肉鬆
肉面	肉麵
肚里	肚裡
肝脏	肝臟
肝郁	肝鬱
股栗	股慄
肥筑方言	肥筑方言
肺脏	肺臟
胃脏	胃臟
胃里	胃裡
背地里	背地裡
胎发展	胎發展
胎发生	胎發生
胎发育	胎發育
胎发	胎髮
胜肽	胜肽
胜鍵	胜鍵
胜键	胜鍵
胡云	胡云
胡子婴	胡子嬰
胡子彤	胡子彤
胡子昂	胡子昂
胡杰	胡杰
胡朴安	胡樸安
胡里胡涂	胡裡胡塗
胰脏	胰臟
能干休	能干休
能干戈	能干戈
能干扰	能干擾
能干政	能干政
能干涉	能干涉
能干预	能干預
能干	能幹
能自制	能自制
脉冲	脈衝
脱谷机	脫穀機
脱发	脫髮
脺脏	脺臟
脾脏	脾臟
腊味	腊味
腊毒	腊毒
腊笔	腊筆
腌臜	腌臢
腌臢	腌臢
肾脏	腎臟
腐干	腐乾
腐余	腐餘
腑脏	腑臟
腕表	腕錶
脑干	腦幹
腰里	腰裡
脚注	腳註
肠脏	腸臟
胶卷	膠捲
胶制	膠製
膨松	膨鬆
膵脏	膵臟
臊子面	臊子麵
脏器	臟器
脏胸	臟胸
脏腑	臟腑
臣仆	臣僕
卧游	臥遊
臧谷亡羊	臧穀亡羊
临潼斗宝	臨潼鬥寶
自干五	自乾五
自制一下	自制一下
自制下来	自制下來
自制不	自制不
自制之力	自制之力
自制之能	自制之能
自制他	自制他
自制伏	自制伏
自制你	自制你
自制力	自制力
自制地	自制地
自制她	自制她
自制情	自制情
自制我	自制我
自制服	自制服
自制的能	自制的能
自制能力	自制能力
自然数里	自然數裡
自由钟	自由鐘
自制	自製
自觉自愿	自覺自愿
自夸	自誇
臭气冲天	臭氣衝天
至多	至多
至多只	至多只
台佟	臺佟
台静农	臺靜農
舂谷	舂穀
举手表	舉手表
舉手表	舉手表
舊庄	舊庄
旧历	舊曆
旧历史	舊歷史
旧游	舊遊
旧表	舊錶
旧钟	舊鐘
旧钟表	舊鐘錶
舌干唇焦	舌乾唇焦
舌叶音	舌葉音
舍入口	舍入口
舒卷	舒捲
舞台风格	舞台風格
舞后	舞后
舞台灯	舞臺燈
航海历	航海曆
航海历史	航海歷史
船只得	船只得
船只有	船只有
船只能	船只能
船钟	船鐘
船只	船隻
舰只	艦隻
色欲	色慾
色长发	色長髮
艳后	艷后
艷后	艷后
艸木丰丰	艸木丰丰
芒果干	芒果乾
花不要采	花不要採
花盆里	花盆裡
花菴词选	花菴詞選
花药	花葯
花钟	花鐘
花马吊嘴	花馬弔嘴
花哄	花鬨
苑里	苑裡
若干	若干
苦干	苦幹
苦里	苦裡
苦斗	苦鬥
苧麻	苧麻
英文里	英文裡
茂都淀	茂都澱
范文同	范文同
范文正公	范文正公
范文澜	范文瀾
范文瀾	范文瀾
范文照	范文照
范文程	范文程
范文芳	范文芳
范文藤	范文藤
范文虎	范文虎
范登堡	范登堡
茅于軾	茅于軾
茅于轼	茅于軾
茶几	茶几
茶余	茶餘
茶面	茶麵
草丛里	草叢裡
草荐	草荐
草席	草蓆
荐居	荐居
荐臻	荐臻
荐饑	荐饑
荐饥	荐饑
庄里	莊裡
茎干	莖幹
莜面	莜麵
莪术	莪朮
莽荡	莽蕩
菜干	菜乾
菜坛	菜罈
菜肴	菜餚
菠棱菜	菠稜菜
菠萝干	菠蘿乾
华严钟	華嚴鐘
万一只	萬一只
萬一只	萬一只
万个	萬個
万周后	萬周後
万天后	萬天後
万年历表	萬年曆錶
万历	萬曆
万历史	萬歷史
万签插架	萬籤插架
万扎	萬紮
万象	萬象
万只	萬隻
万余	萬餘
落腮胡	落腮鬍
落发	落髮
叶叶琴	葉叶琴
葉叶琴	葉叶琴
叶叶琹	葉叶琹
葉叶琹	葉叶琹
叶阳后	葉陽后
葉陽后	葉陽后
葡萄干	葡萄乾
董家里	董家里
董氏封发	董氏封髮
葫芦里卖甚么药	葫蘆裡賣甚麼藥
蒙雾露	蒙霧露
蒜发	蒜髮
蒲席	蒲蓆
蒸干	蒸乾
蒸制	蒸製
苍术	蒼朮
苍发	蒼髮
苍郁	蒼鬱
蓄发	蓄髮
蓄胡	蓄鬍
蓄须	蓄鬚
席子	蓆子
蓊郁	蓊鬱
蓬发	蓬髮
蓬松	蓬鬆
蓬松松	蓬鬆鬆
参绥	蔘綏
葱郁	蔥鬱
荞麦面	蕎麥麵
芸薹	蕓薹
荡来荡去	蕩來蕩去
荡女	蕩女
荡妇	蕩婦
荡寇	蕩寇
荡平	蕩平
荡气	蕩氣
荡涤	蕩滌
荡漾	蕩漾
荡然	蕩然
荡产	蕩產
荡舟	蕩舟
荡船	蕩船
荡荡	蕩蕩
萧参	蕭蔘
薄幸	薄倖
薄干	薄幹
姜啤	薑啤
姜是老的辣	薑是老的辣
姜末	薑末
姜桂	薑桂
姜母	薑母
姜汁	薑汁
姜汤	薑湯
姜片	薑片
姜糖	薑糖
姜丝	薑絲
姜老辣	薑老辣
姜茶	薑茶
姜蓉	薑蓉
姜还是老的辣	薑還是老的辣
姜酮	薑酮
姜饼	薑餅
姜黄	薑黃
薙发	薙髮
薝卜	薝蔔
熏心	薰心
熏染	薰染
熏沐	薰沐
熏习	薰習
熏陶	薰陶
熏风	薰風
熏香	薰香
苧悴	薴悴
苧烯	薴烯
薴烯	薴烯
借以	藉以
借助	藉助
借口	藉口
借寇兵	藉寇兵
借手	藉手
借故	藉故
借机	藉機
借此	藉此
借由	藉由
借箸代筹	藉箸代籌
借资	藉資
蓝淀	藍澱
藏历	藏曆
藏历史	藏歷史
藏蒙歌儿	藏矇歌兒
藤席	藤蓆
藤制	藤製
药签	藥籤
药面儿	藥麵兒
苏昆	蘇崑
𬞟	蘋
苹婆	蘋婆
苹果	蘋果
苹果干	蘋果乾
兰溪市	蘭谿市
萝卜	蘿蔔
萝卜干	蘿蔔乾
虎须	虎鬚
虎斗	虎鬥
虚夸	虛誇
号志	號誌
虫部	虫部
蚊动牛斗	蚊動牛鬥
蛇发女妖	蛇髮女妖
蛋白发	蛋白發
蜂后	蜂后
蜂涌	蜂湧
蜂准	蜂準
蜜里调油	蜜裡調油
蜡月	蜡月
蜡祭	蜡祭
蝎虎	蝎虎
蝎蝎螫螫	蝎蝎螫螫
蝎谮	蝎譖
虾面	蝦麵
虮虱相吊	蟣蝨相弔
蛏干	蟶乾
蚁后	蟻后
蟻后	蟻后
蚃干	蠁幹
蛮干	蠻幹
血余	血餘
行事历	行事曆
行事历史	行事歷史
行凶	行兇
行家里手	行家裡手
街庄	街庄
卫后庄公	衛後莊公
卫星钟	衛星鐘
冲上	衝上
冲下	衝下
冲来	衝來
冲倒	衝倒
冲冠	衝冠
冲出	衝出
冲到	衝到
冲刺	衝刺
冲克	衝剋
冲力	衝力
冲劲	衝勁
冲动	衝動
冲去	衝去
冲口	衝口
冲呀	衝呀
冲啊	衝啊
冲垮	衝垮
冲堂	衝堂
冲坚陷阵	衝堅陷陣
冲压	衝壓
冲天炮	衝天炮
冲州撞府	衝州撞府
冲心	衝心
冲掉	衝掉
冲撞	衝撞
冲击	衝擊
冲散	衝散
冲杀	衝殺
冲决	衝決
冲波	衝波
冲浪	衝浪
冲激	衝激
冲然	衝然
冲盹	衝盹
衝着	衝着
冲破	衝破
冲程	衝程
冲突	衝突
冲线	衝線
冲要	衝要
冲起	衝起
冲车	衝車
冲进	衝進
冲过	衝過
冲量	衝量
冲锋	衝鋒
冲锋枪	衝鋒鎗
冲陷	衝陷
冲头阵	衝頭陣
冲风	衝風
衡鉴	衡鑑
表征	表徵
表面包	表面包
袋杆	袋桿
袋里	袋裡
袋表	袋錶
袖里	袖裡
被废后	被廢後
被卷回	被捲回
被系上	被繫上
被里	被裡
被夸	被誇
被发佯狂	被髮佯狂
被发入山	被髮入山
被发左衽	被髮左衽
被发缨冠	被髮纓冠
被发阳狂	被髮陽狂
夹衣	袷衣
夹裙	袷裙
裁并	裁併
裁制	裁製
里水镇	裏水鎮
里海	裏海
里白	裏白
里运河	裏運河
补注	補註
装折	裝摺
里勾外连	裡勾外連
里屋	裡屋
里层	裡層
里带	裡帶
里弦	裡弦
里应外合	裡應外合
里衣	裡衣
里通外国	裡通外國
里通外敌	裡通外敵
里边	裡邊
里间	裡間
里面	裡面
里面包	裡面包
里头	裡頭
制件	製件
制作	製作
制做	製做
制备	製備
制冰	製冰
制冷	製冷
制剂	製劑
制取	製取
制品	製品
制售	製售
制图	製圖
制得	製得
制成	製成
制毒	製毒
制法	製法
制汉字	製漢字
制浆	製漿
制片	製片
制版	製版
制发	製發
制程	製程
制糖	製糖
制纸	製紙
制药	製藥
制衣	製衣
制表键	製表鍵
制贩	製販
制造	製造
制酒	製酒
制铁	製鐵
制革	製革
制鞋	製鞋
制盐	製鹽
复元音	複元音
复函数	複函數
复分数	複分數
复分析	複分析
复分解	複分解
复列	複列
复利	複利
复印	複印
复句	複句
复合	複合
复壁	複壁
复姓	複姓
复字键	複字鍵
复写	複寫
复对数	複對數
复平面	複平面
复式	複式
复数	複數
复方	複方
复本	複本
复查	複查
复次	複次
复比	複比
复决	複決
复流	複流
复测	複測
复目	複目
复眼	複眼
复种	複種
复穗	複穗
复线	複線
复习	複習
复色	複色
复叶	複葉
复制	複製
复诊	複診
复评	複評
复词	複詞
复试	複試
复课	複課
复议	複議
复读机	複讀機
复变函数	複變函數
复赛	複賽
复辅音	複輔音
复述	複述
复选	複選
复钱	複錢
复阅	複閱
复杂	複雜
复音	複音
复韵	複韻
褒赞	褒讚
衬里	襯裡
西井里	西井里
西周钟	西周鐘
西昆	西崑
西岳	西嶽
西历	西曆
西历代	西歷代
西历任	西歷任
西历史	西歷史
西历次	西歷次
西湖里	西湖里
西西里	西西里
西谷米	西谷米
西游	西遊
要自制	要自制
要冲	要衝
复信	覆信
复审	覆審
复核	覆核
见棱见角	見稜見角
见素抱朴	見素抱樸
见钟不打	見鐘不打
规划	規劃
规范	規範
观采	觀採
角抵	角牴
角落发	角落發
角落里	角落裡
觚棱	觚稜
解雇	解僱
解封后	解封後
解铃仍须系铃人	解鈴仍須繫鈴人
解铃还须系铃人	解鈴還須繫鈴人
解发佯狂	解髮佯狂
触须	觸鬚
言云	言云
言大而夸	言大而夸
言里	言裡
订制	訂製
计划	計劃
计时表	計時錶
托了	託了
托事	託事
托交	託交
托付	託付
托克逊	託克遜
托古讽今	託古諷今
托名	託名
托命	託命
托咎	託咎
托梦	託夢
托孤	託孤
托庇	託庇
托故	託故
托疾	託疾
托病	託病
托管	託管
托言	託言
托词	託詞
托买	託買
托卖	託賣
托身	託身
托辞	託辭
托运	託運
托过	託過
托里县	託里縣
托附	託附
許愿起經	許愿起經
许愿起经	許愿起經
許聖杰	許聖杰
注上	註上
注册	註冊
注失	註失
注定	註定
注明	註明
注标	註標
注生娘娘	註生娘娘
注疏	註疏
注脚	註腳
注里	註裡
注解	註解
注记	註記
注译	註譯
注销	註銷
注：	註：
证谏	証諫
评断发	評斷發
评注	評註
评鉴	評鑑
词干	詞幹
词汇	詞彙
词里	詞裡
词余	詞餘
试制	試製
詩云	詩云
诗云	詩云
诗赞	詩讚
诗钟	詩鐘
诗余	詩餘
话里有话	話裡有話
该钟	該鐘
详征博引	詳徵博引
详注	詳註
诔赞	誄讚
夸下海口	誇下海口
夸了	誇了
夸人	誇人
夸他	誇他
夸你	誇你
夸来夸去	誇來誇去
夸别	誇別
夸功	誇功
夸胜道强	誇勝道強
夸口	誇口
夸嘴	誇嘴
夸多斗靡	誇多鬥靡
夸大	誇大
夸她	誇她
夸姣	誇姣
夸官	誇官
夸容	誇容
夸张	誇張
夸强说会	誇強說會
夸得	誇得
夸成	誇成
夸我	誇我
夸才	誇才
夸毗	誇毗
夸海口	誇海口
夸奖	誇獎
夸示	誇示
夸称	誇稱
夸耀	誇耀
夸能	誇能
夸能斗智	誇能鬥智
夸诩	誇詡
夸夸	誇誇
夸夸其谈	誇誇其談
夸诞	誇誕
夸说	誇說
夸赞	誇讚
夸起	誇起
夸辩	誇辯
夸过	誇過
夸饰	誇飾
夸丽	誇麗
志哀	誌哀
志喜	誌喜
志庆	誌慶
志异	誌異
认准	認準
诱奸	誘姦
语云	語云
语汇	語彙
語有云	語有云
语有云	語有云
语法里	語法裡
语里	語裡
诚征	誠徵
诚朴	誠樸
诬蔑	誣衊
说不准	說不準
谁干的	誰幹的
课征	課徵
课余	課餘
调准	調準
调制	調製
调钟表	調鐘錶
谈征	談徵
请君入瓮	請君入甕
请托	請託
论文里	論文裡
咨询	諮詢
咨议	諮議
诸余	諸餘
谋干	謀幹
謝杰	謝杰
谢杰	謝杰
謝華后	謝華后
谢华后	謝華后
谬采虚声	謬採虛聲
谬赞	謬讚
謷丑	謷醜
謹愿	謹愿
谨愿	謹愿
哗噪	譁噪
哗嚣	譁囂
哗然	譁然
哗众	譁眾
哗笑	譁笑
哗变	譁變
噪诈	譟詐
警世钟	警世鐘
警报钟	警報鐘
警示钟	警示鐘
警钟	警鐘
译文里	譯文裡
译制	譯製
译注	譯註
护发展	護發展
护发	護髮
变征	變徵
变丑	變醜
仇隙	讎隙
赞一个	讚一個
赞不绝口	讚不絕口
赞佩	讚佩
赞呗	讚唄
赞叹	讚嘆
赞岐	讚岐
赞扬	讚揚
赞乐	讚樂
赞歌	讚歌
赞美	讚美
赞羡	讚羨
赞许	讚許
赞词	讚詞
赞誉	讚譽
赞赏	讚賞
赞辞	讚辭
赞颂	讚頌
谷子敬	谷子敬
豆干	豆乾
豆腐干	豆腐乾
丰度	豐度
丰滨	豐濱
丰滨乡	豐濱鄉
丰台	豐臺
豔后	豔后
象征	象徵
贪欲	貪慾
貴价	貴价
贵价	貴价
貴子里	貴子里
贵干	貴幹
贵征	貴徵
买凶	買兇
买断发	買斷發
費米面	費米面
费米面	費米面
贻范	貽範
賈后	賈后
贾后	賈后
赈饥	賑饑
赏赞	賞讚
賢后	賢后
贤后	賢后
卖断发	賣斷發
賦范	賦范
赋范	賦范
质数里	質數裡
质朴	質樸
賭后	賭后
赌后	賭后
赌台	賭檯
赌斗	賭鬥
购并	購併
购买欲	購買慾
赘余	贅餘
赢余	贏餘
赤术	赤朮
赤绳系足	赤繩繫足
走回路	走回路
起哄	起鬨
超市里	超市裡
超级杯	超級盃
超赞	超讚
赶制	趕製
赶面棍	趕麵棍
赵威后	趙威后
趙威后	趙威后
赵惠后	趙惠后
趙惠后	趙惠后
赵治勋	趙治勳
趱干	趲幹
足协杯	足協盃
足球台	足球台
足总杯	足總盃
跌扑	跌扑
路图里	路圖裡
路签	路籤
路面	路面
跳荡	跳蕩
局蹐	跼蹐
局躅	跼躅
踡局	踡跼
逾闲	踰閑
蹒局	蹣跼
蹭棱子	蹭稜子
躁郁	躁鬱
身体发肤	身體髮膚
躯干	軀幹
车库里	車庫裡
车站里	車站裡
车里	車裡
车里雅宾斯克	車里雅賓斯克
轨范	軌範
轩辟	軒闢
挽曲	輓曲
挽歌	輓歌
挽联	輓聯
挽词	輓詞
挽诗	輓詩
挽车	輓車
挽输	輓輸
挽辞	輓辭
轻松	輕鬆
轻松松	輕鬆鬆
轮奸	輪姦
轮回	輪迴
轉向	轉向
转向	轉向
转托	轉託
转斗千里	轉鬥千里
辛丑	辛丑
辟谷	辟穀
辣面	辣麵
办公台	辦公檯
辞汇	辭彙
辫发	辮髮
辩斗	辯鬥
辰溪县	辰谿縣
农历	農曆
农历史	農歷史
农民历	農民曆
农民历史	農民歷史
迂回	迂迴
近日无仇	近日無讎
返朴	返樸
迥然回异	迥然迴異
回光返照	迴光返照
回圈	迴圈
回廊	迴廊
回形夹	迴形夾
回文序列	迴文序列
回文数	迴文數
回文构词	迴文構詞
回文结构	迴文結構
回文联	迴文聯
回文诗	迴文詩
回文锦	迴文錦
回旋	迴旋
回环	迴環
回纹针	迴紋針
回绕	迴繞
回翔	迴翔
回肠	迴腸
回肠荡气	迴腸盪氣
回荡	迴蕩
回诵	迴誦
回路	迴路
回转	迴轉
回递性	迴遞性
回避	迴避
回銮	迴鑾
回响	迴響
回风	迴風
迷蒙	迷濛
追凶	追兇
退伙	退夥
送钟	送鐘
逆钟	逆鐘
逆钟向	逆鐘向
逆风后	逆風後
逋发	逋髮
逍遥游	逍遙遊
透辟	透闢
这出世	這出世
这出乎	這出乎
这出人	這出人
这出版	這出版
这出现	這出現
这出生	這出生
这出色	這出色
这出身	這出身
这出道	這出道
这只不	這只不
这只不过	這只不過
这只允	這只允
这只包括	這只包括
这只可	這只可
这只在	這只在
这只容	這只容
这只应	這只應
这只采	這只採
这只是	這只是
这只会	這只會
这只比	這只比
这只用	這只用
这只能	這只能
这只要	這只要
这只限	這只限
这只需	這只需
这只须	這只須
这伙人	這夥人
这里	這裡
这钟	這鐘
这只	這隻
这么干	這麼幹
这出	這齣
通奸	通姦
通心面	通心麵
通历	通曆
通历史	通歷史
通鉴	通鑑
逞凶斗狠	逞兇鬥狠
造钟	造鐘
连三并四	連三併四
连亘	連亙
连采	連採
连发式	連發式
连系	連繫
周游	週遊
进两出	進兩出
進制	進制
逼并	逼併
遇风后	遇風後
游了	遊了
游人	遊人
游仙	遊仙
游伴	遊伴
游侠	遊俠
游冶	遊冶
游刃	遊刃
游动	遊動
游园	遊園
游子	遊子
游学	遊學
游客	遊客
游宦	遊宦
游山玩水	遊山玩水
游廊	遊廊
游必有方	遊必有方
游憩	遊憩
游戏	遊戲
游戏里	遊戲裡
游手好闲	遊手好閒
游方	遊方
游族网络	遊族網絡
游星	遊星
游春	遊春
游乐	遊樂
游历	遊歷
游民	遊民
游河	遊河
游猎	遊獵
游玩	遊玩
游目骋怀	遊目騁懷
游程	遊程
游丝	遊絲
游美学务	遊美學務
游兴	遊興
游船	遊船
游艇	遊艇
游荡	遊蕩
游艺	遊藝
游行	遊行
游街	遊街
游览	遊覽
游记	遊記
游说	遊說
游资	遊資
游走	遊走
游踪	遊蹤
游轮	遊輪
游逛	遊逛
游错	遊錯
游骑兵	遊騎兵
游魂	遊魂
过水面	過水麵
遏制	遏制
道范	道範
道里区	道裏區
递回	遞迴
远游	遠遊
遨游	遨遊
遮丑	遮醜
选手表明	選手表明
选手表决	選手表決
选手表现	選手表現
选手表示	選手表示
选手表达	選手表達
遗传钟	遺傳鐘
遗范	遺範
遗迹	遺蹟
辽沈	遼瀋
邀天之幸	邀天之倖
还采	還採
还冲	還衝
邋里邋遢	邋裡邋遢
邢台	邢臺
那只不过	那只不過
那只包括	那只包括
那只可	那只可
那只在	那只在
那只怕	那只怕
那只应	那只應
那只是	那只是
那只会	那只會
那只有	那只有
那只比	那只比
那只用	那只用
那只能	那只能
那只要	那只要
那只限	那只限
那只需	那只需
那只须	那只須
那卷	那捲
那美克星	那美克星
那里	那裡
那只	那隻
邱于庭	邱于庭
郁朴	郁樸
郁郁菲菲	郁郁菲菲
郁郁青青	郁郁青青
郊游	郊遊
郘钟	郘鐘
部子里	部子里
部落发	部落發
郭后	郭后
都市里	都市裡
乡愿	鄉愿
鄉愿	鄉愿
郑凯云	鄭凱云
鄭凱云	鄭凱云
郑苹如	鄭蘋如
配制饲料	配制飼料
配图里	配圖裡
配制	配製
酒帘	酒帘
酒气冲天	酒氣衝天
酒坛	酒罈
酒肴	酒餚
酒曲	酒麴
酒麹	酒麴
酥松	酥鬆
酸姜	酸薑
腌制	醃製
醇朴	醇樸
醋坛	醋罈
丑丫头	醜丫頭
丑事	醜事
丑人	醜人
丑侪	醜儕
丑八怪	醜八怪
丑剌剌	醜剌剌
丑剧	醜劇
丑化	醜化
丑史	醜史
丑名	醜名
丑吒	醜吒
丑地	醜地
丑夷	醜夷
丑女	醜女
丑女效颦	醜女效顰
丑奴儿	醜奴兒
丑妇	醜婦
丑媳	醜媳
丑媳妇	醜媳婦
丑小鸭	醜小鴨
丑巴怪	醜巴怪
丑徒	醜徒
丑恶	醜惡
丑态	醜態
丑毙了	醜斃了
丑末	醜末
丑样	醜樣
丑死	醜死
丑比	醜比
丑沮	醜沮
丑男	醜男
丑闻	醜聞
丑声	醜聲
丑声远播	醜聲遠播
丑脸	醜臉
丑虏	醜虜
丑行	醜行
丑言	醜言
丑诋	醜詆
丑话	醜話
丑语	醜語
丑贼生	醜賊生
丑辞	醜辭
丑辱	醜辱
丑逆	醜逆
丑丑	醜醜
丑陋	醜陋
丑杂	醜雜
丑头怪脸	醜頭怪臉
丑类	醜類
酿制	釀製
衅钟	釁鐘
采石之役	采石之役
采石之战	采石之戰
采石之戰	采石之戰
采石矶	采石磯
采石磯	采石磯
里海大学	里海大學
里海大學	里海大學
里海崖	里海崖
里海茨	里海茨
里铺	里舖
重回	重回
重罗面	重羅麵
重制	重製
重复	重複
重托	重託
重游	重遊
野姜	野薑
野游	野遊
量不准	量不準
厘改	釐改
厘整	釐整
厘正	釐正
厘毫	釐毫
厘清	釐清
厘订	釐訂
厘革	釐革
金仆姑	金僕姑
金城里	金城里
金发放	金發放
金范	金範
金圣叹	金聖歎
金表情	金表情
金表态	金表態
金表扬	金表揚
金表明	金表明
金表演	金表演
金表现	金表現
金表示	金表示
金表达	金表達
金表露	金表露
金表面	金表面
金装玉里	金裝玉裡
金溪县	金谿縣
金链	金鍊
金钟	金鐘
金发	金髮
钩心斗角	鈎心鬥角
银朱	銀硃
银发	銀髮
铜范	銅範
铜制	銅製
铜钟	銅鐘
铯钟	銫鐘
锈病	銹病
铝制	鋁製
锌制	鋅製
钢之炼金术师	鋼之鍊金術師
钢制	鋼製
录制	錄製
锤炼	錘鍊
钱谷	錢穀
钱范	錢範
锦卤	錦滷
锦绣花园	錦綉花園
表停	錶停
表冠	錶冠
表带	錶帶
表板	錶板
表王	錶王
表盘	錶盤
表蒙子	錶蒙子
表转	錶轉
表速	錶速
表针	錶針
炼冶	鍊冶
炼句	鍊句
炼字	鍊字
炼师	鍊師
炼度	鍊度
炼形	鍊形
炼气	鍊氣
炼汞	鍊汞
炼石	鍊石
链表	鍊表
炼贫	鍊貧
炼金术	鍊金術
锲而不舍	鍥而不捨
镰仓	鎌倉
镇里	鎮裡
镜图里	鏡圖裡
钟上	鐘上
钟下	鐘下
钟不	鐘不
钟不扣不鸣	鐘不扣不鳴
钟不撞不鸣	鐘不撞不鳴
钟不敲不响	鐘不敲不響
钟不空则哑	鐘不空則啞
钟乳洞	鐘乳洞
钟乳石	鐘乳石
钟停	鐘停
钟匠	鐘匠
钟口	鐘口
钟在寺里	鐘在寺裡
钟塔	鐘塔
钟壁	鐘壁
钟太	鐘太
钟好	鐘好
钟山	鐘山
钟左右	鐘左右
钟差	鐘差
钟座	鐘座
钟形	鐘形
钟形虫	鐘形蟲
钟律	鐘律
钟摆	鐘擺
钟敲	鐘敲
钟有	鐘有
钟楼	鐘樓
钟模	鐘模
钟没	鐘沒
钟漏	鐘漏
钟王	鐘王
钟琴	鐘琴
钟发音	鐘發音
钟的	鐘的
钟盘	鐘盤
钟相	鐘相
钟磬	鐘磬
钟纽	鐘紐
钟罩	鐘罩
钟声	鐘聲
钟腰	鐘腰
钟花	鐘花
钟螺	鐘螺
钟行	鐘行
钟表面	鐘表面
钟被	鐘被
钟调	鐘調
钟身	鐘身
钟速	鐘速
钟表	鐘錶
钟表停	鐘錶停
钟表盘	鐘錶盤
钟表速	鐘錶速
钟关	鐘關
钟陈列	鐘陳列
钟面	鐘面
钟响	鐘響
钟顶	鐘頂
钟头	鐘頭
钟体	鐘體
钟鸣	鐘鳴
钟点	鐘點
钟鼎	鐘鼎
钟鼓	鐘鼓
铁制	鐵製
铁钟	鐵鐘
铸钟	鑄鐘
鉴别	鑑別
鉴古	鑑古
鉴定	鑑定
鉴察	鑑察
鉴往知来	鑑往知來
鉴戒	鑑戒
鉴于	鑑於
鉴湖	鑑湖
鉴藏	鑑藏
鉴谅	鑑諒
鉴证	鑑證
鉴识	鑑識
鉴赏	鑑賞
長几	長几
长几	長几
长得丑	長得醜
长历	長曆
长历史	長歷史
长发公主	長髮公主
长发妹	長髮妹
长发姑娘	長髮姑娘
长须	長鬚
门帘	門帘
门吊儿	門弔兒
门里	門裡
闫怀礼	閆懷禮
开封后	開封後
開山辟谷	開山辟谷
开山辟谷	開山闢谷
开吊	開弔
开征	開徵
开采	開採
开发	開發
开辟	開闢
开哄	開鬨
闲邪	閑邪
闲情逸致	閒情逸緻
闲荡	閒蕩
闲游	閒遊
间不容发	間不容髮
间里	間裡
闵采尔	閔採爾
闺范	閨範
阃范	閫範
闯荡	闖蕩
闯炼	闖鍊
关系	關係
关注：	關注：
關注：	關注：
关系列	關系列
关系所	關系所
关系科	關系科
关系统	關系統
辟佛	闢佛
辟作	闢作
辟划	闢劃
辟土	闢土
辟地	闢地
辟室	闢室
辟建	闢建
辟为	闢為
辟田	闢田
辟筑	闢築
辟谣	闢謠
辟辟	闢辟
辟邪以律	闢邪以律
防制法	防制法
防水表	防水錶
防御	防禦
防范	防範
阿里	阿里
附注	附註
限制	限制
院里	院裡
陪吊	陪弔
阴干	陰乾
阴历	陰曆
阴历史	陰歷史
阴沟里翻船	陰溝裡翻船
阴郁	陰鬱
陳冲	陳冲
陳士杰	陳士杰
陈升	陳昇
陈有后	陳有后
陳有后	陳有后
陈杰	陳杰
陳杰	陳杰
陈炼	陳鍊
陶制	陶製
阳春面	陽春麵
阳历	陽曆
阳历史	陽歷史
阳谷	陽穀
隆准许	隆准許
隆准	隆準
队里	隊裡
隐占	隱佔
隐几	隱几
隱几	隱几
只字	隻字
只影	隻影
只手遮天	隻手遮天
只眼	隻眼
只言片语	隻言片語
只身	隻身
雄斗斗	雄斗斗
雅范	雅範
集团	集團
集数里	集數裡
集里	集裡
集游法	集遊法
双折射	雙折射
双折	雙摺
双胜类	雙胜類
雙胜類	雙胜類
双雕	雙鵰
杂合面儿	雜合麵兒
杂志	雜誌
杂面	雜麵
鸡吵鹅斗	雞吵鵝鬥
鸡奸	雞姦
鸡争鹅斗	雞爭鵝鬥
鸡丝	雞絲
鸡丝面	雞絲麵
鸡腿面	雞腿麵
鸡蛋里挑骨头	雞蛋裡挑骨頭
鸡只	雞隻
难舍	難捨
雨蒙蒙	雨濛濛
雪窗萤几	雪窗螢几
雪窗螢几	雪窗螢几
雪里	雪裡
雪里红	雪裡紅
雪里蕻	雪裡蕻
云南个旧	雲南箇舊
云吞	雲吞
云吞面	雲吞麵
云笈七签	雲笈七籤
云里雾里	雲裡霧裡
云游	雲遊
云须	雲鬚
零个	零個
零周后	零周後
零天后	零天後
零只	零隻
零余	零餘
电子表格	電子表格
电子制表	電子製表
电子钟	電子鐘
电子钟表	電子鐘錶
电影后	電影後
电影里	電影裡
电梯里	電梯裡
电波钟	電波鐘
电码表	電碼表
电冲	電衝
电视台风	電視台風
电视里	電視裡
电表	電錶
电钟	電鐘
震栗	震慄
霉气冲天	霉氣衝天
沾化	霑化
沾益	霑益
雾里	霧裡
露丑	露醜
霁范	霽範
灵昆	靈崑
青山一发	青山一髮
青春斗	青春鬥
青霉	青黴
非常准	非常準
面包住	面包住
面包含	面包含
面包围	面包圍
面包圍	面包圍
面包容	面包容
面包庇	面包庇
面包厢	面包廂
面包抄	面包抄
面包括	面包括
面包揽	面包攬
面包涵	面包涵
面包管	面包管
面包扎	面包紮
面包罗	面包羅
面包藏	面包藏
面包装	面包裝
面包裝	面包裝
面包裹	面包裹
面包起	面包起
面包办	面包辦
面店铺	面店鋪
面条目	面條目
面條目	面條目
面粉碎	面粉碎
面粉红	面粉紅
面食饭	面食飯
鞋里	鞋裡
鞣制	鞣製
秋千	鞦韆
鞭辟入里	鞭辟入裡
韦席	韋蓆
韩国制	韓國製
韩制	韓製
音不准	音不準
音准	音準
音声如钟	音聲如鐘
韶山冲	韶山沖
响钟	響鐘
頁面	頁面
页面	頁面
顶凶	頂兇
頂多	頂多
顶多	頂多
项链	項鍊
顺钟向	順鐘向
顺风后	順風後
须根据	須根據
颂系	頌繫
颂赞	頌讚
预报不准	預報不準
预制	預製
领袖欲	領袖慾
头乱发	頭亂髮
頭前庄	頭前庄
头发动	頭發動
头发展	頭發展
头发现	頭發現
头发生	頭發生
头里	頭裡
头长发	頭長髮
头发	頭髮
颊须	頰鬚
颈须	頸鬚
额征	額徵
额我略历	額我略曆
额我略历史	額我略歷史
颜范	顏範
颛顼历	顓頊曆
顛顛仆仆	顛顛仆仆
颠颠仆仆	顛顛仆仆
颤栗	顫慄
显示表明	顯示表明
显示表格	顯示表格
显示表现	顯示表現
显示表示	顯示表示
显示表达	顯示表達
显示表面	顯示表面
显示表头	顯示表頭
显示表	顯示錶
显示钟	顯示鐘
显示钟表	顯示鐘錶
风干	風乾
風后	風后
风后	風后
风土志	風土誌
风后，	風後，
风卷残云	風捲殘雲
风物志	風物誌
风范	風範
风里	風裡
风起云涌	風起雲湧
风刮	風颳
台风	颱風
台风后	颱風後
刮了	颳了
刮倒	颳倒
刮大风	颳大風
刮得	颳得
刮走	颳走
刮起	颳起
刮雪	颳雪
刮风	颳風
刮风后	颳風後
飘荡	飄蕩
飘游	飄遊
飘飘荡荡	飄飄蕩蕩
飘发	飄髮
飞扎	飛紮
飞刍挽粟	飛芻輓粟
飞行钟	飛行鐘
食欲	食慾
食欲不振	食欲不振
食面	食麵
饭后钟	飯後鐘
饭团	飯糰
饼干	餅乾
养脏	養臟
餐台	餐檯
馂余	餕餘
余0	餘0
余1	餘1
余2	餘2
余3	餘3
余4	餘4
余5	餘5
余6	餘6
余7	餘7
余8	餘8
余9	餘9
余〇	餘〇
余一	餘一
余七	餘七
余三	餘三
余下	餘下
余九	餘九
余事	餘事
余二	餘二
余五	餘五
余人	餘人
余俗	餘俗
余倍	餘倍
余僇	餘僇
余光	餘光
余八	餘八
余六	餘六
余刃	餘刃
余切	餘切
余利	餘利
余割	餘割
余力	餘力
余勇	餘勇
余十	餘十
余味	餘味
余喘	餘喘
余四	餘四
余地	餘地
余墨	餘墨
余外	餘外
余妙	餘妙
余姚	餘姚
余威	餘威
余子	餘子
余存	餘存
余孽	餘孽
余干	餘干
余年	餘年
余式	餘式
余弦	餘弦
余思	餘思
余悸	餘悸
余庆	餘慶
余数	餘數
余明	餘明
余映	餘映
余暇	餘暇
余晖	餘暉
余暨	餘暨
余杭	餘杭
余杯	餘杯
余桃	餘桃
余桶	餘桶
余业	餘業
余款	餘款
余欢	餘歡
余步	餘步
余殃	餘殃
余毒	餘毒
余气	餘氣
余江	餘江
余波	餘波
余温	餘溫
余泽	餘澤
余沥	餘瀝
余烈	餘烈
余热	餘熱
余烬	餘燼
余珍	餘珍
余生	餘生
余留	餘留
余众	餘眾
余窍	餘竅
余粮	餘糧
余绪	餘緒
余缺	餘缺
余罪	餘罪
余羡	餘羨
余声	餘聲
余膏	餘膏
余兴	餘興
余蓄	餘蓄
余荫	餘蔭
余裕	餘裕
余角	餘角
余论	餘論
余责	餘責
余貾	餘貾
余辉	餘輝
余辜	餘辜
余部	餘部
余酲	餘酲
余量	餘量
余闰	餘閏
余闲	餘閒
余零	餘零
余震	餘震
余霞	餘霞
余音	餘音
余韵	餘韻
余响	餘響
余项	餘項
余额	餘額
余风	餘風
余食	餘食
余党	餘黨
肴羞	餚羞
肴馔	餚饌
馄饨面	餛飩麵
馆谷	館穀
馆里	館裡
饥寒	饑寒
饥民	饑民
饥渴	饑渴
饥溺	饑溺
饥荒	饑荒
饥饱	饑飽
饥馑	饑饉
首当其冲	首當其衝
首发	首發
首只	首隻
首出电影	首齣電影
香干	香乾
香山庄	香山庄
马干	馬乾
馬占山	馬占山
马德钟	馬德鐘
马斯垂克期	馬斯垂克期
馬格里布	馬格里布
马格里布	馬格里布
马回岭	馬迴嶺
马云：	馬雲：
驻扎	駐紮
骀荡	駘蕩
腾格里	騰格里
騰格里	騰格里
腾涌	騰湧
腾冲	騰衝
惊栗	驚慄
惊赞	驚讚
惊钟	驚鐘
骨干	骨幹
骨灰坛	骨灰罈
骨坛	骨罈
体征	體徵
体范	體範
体系	體系
体里	體裡
高几	高几
高后	高后
高干扰	高干擾
高干预	高干預
高干	高幹
高度自制	高度自制
高涌泉	高涌泉
高清愿	高清愿
髡发	髡髮
髭胡	髭鬍
髭须	髭鬚
发上指冠	髮上指冠
发上冲冠	髮上沖冠
发乳	髮乳
发光可鉴	髮光可鑑
发匪	髮匪
发及腰	髮及腰
发型	髮型
发夹	髮夾
发妻	髮妻
发屋	髮屋
发已霜白	髮已霜白
发带	髮帶
发廊	髮廊
发式	髮式
发引千钧	髮引千鈞
发披肩	髮披肩
发卷	髮捲
发根	髮根
发油	髮油
发漂	髮漂
发为血之本	髮為血之本
发状	髮狀
发癣	髮癬
发短心长	髮短心長
发禁	髮禁
发笺	髮箋
发簪	髮簪
发纱	髮紗
发结	髮結
发丝	髮絲
发网菌	髮網菌
发脚	髮腳
发肤	髮膚
发胶	髮膠
发菜	髮菜
发蜡	髮蠟
发踊冲冠	髮踊沖冠
髮踊沖冠	髮踊沖冠
发辫	髮辮
发钗	髮釵
发长	髮長
发际	髮際
发雕	髮雕
发霜	髮霜
发饰	髮飾
发髻	髮髻
发鬓	髮鬢
髯胡	髯鬍
髼松	髼鬆
鬅松	鬅鬆
松一口气	鬆一口氣
松了	鬆了
松些	鬆些
松元音	鬆元音
松劲	鬆勁
松动	鬆動
松化	鬆化
松口	鬆口
松喉	鬆喉
松土	鬆土
松宽	鬆寬
松弛	鬆弛
松快	鬆快
松懈	鬆懈
松手	鬆手
松掉	鬆掉
松散	鬆散
松柔	鬆柔
松气	鬆氣
松浮	鬆浮
松绑	鬆綁
松紧	鬆緊
松缓	鬆緩
松耦合	鬆耦合
松脆	鬆脆
松脱	鬆脫
松蛋	鬆蛋
松软	鬆軟
松通	鬆通
松开	鬆開
松饼	鬆餅
松松地	鬆鬆地
鬈发	鬈髮
胡子	鬍子
胡梢	鬍梢
胡渣	鬍渣
胡髭	鬍髭
胡髯	鬍髯
胡须	鬍鬚
鬒发	鬒髮
须根	鬚根
须毛	鬚毛
须生	鬚生
须眉	鬚眉
须叶藤	鬚葉藤
须发	鬚髮
须胡	鬚鬍
须须	鬚鬚
须鲨	鬚鯊
须鲸	鬚鯨
鬓发	鬢髮
斗不过	鬥不過
斗了	鬥了
斗来斗去	鬥來鬥去
斗倒	鬥倒
斗分子	鬥分子
斗剑	鬥劍
斗力	鬥力
斗劲	鬥勁
斗勇	鬥勇
斗胜	鬥勝
斗合	鬥合
斗嘴	鬥嘴
斗地主	鬥地主
斗垮	鬥垮
斗士	鬥士
斗富	鬥富
斗巧	鬥巧
斗幌子	鬥幌子
斗弄	鬥弄
斗引	鬥引
斗别气	鬥彆氣
斗彩	鬥彩
斗心眼	鬥心眼
斗志	鬥志
斗闷	鬥悶
斗成	鬥成
斗战	鬥戰
斗打	鬥打
斗批改	鬥批改
斗技	鬥技
斗败	鬥敗
斗文	鬥文
斗智	鬥智
斗暴	鬥暴
斗武	鬥武
斗殴	鬥毆
斗气	鬥氣
斗法	鬥法
斗争	鬥爭
斗争斗合	鬥爭鬥合
斗牌	鬥牌
斗牙拌齿	鬥牙拌齒
斗牙斗齿	鬥牙鬥齒
斗牛	鬥牛
斗犀台	鬥犀臺
斗犬	鬥犬
斗狗	鬥狗
斗狠	鬥狠
斗兽	鬥獸
斗叠	鬥疊
斗百草	鬥百草
斗眼	鬥眼
斗私批修	鬥私批修
斗而铸兵	鬥而鑄兵
斗而铸锥	鬥而鑄錐
斗脚	鬥腳
斗舰	鬥艦
斗茶	鬥茶
斗草	鬥草
斗叶儿	鬥葉兒
斗叶子	鬥葉子
斗蛐	鬥蛐
斗蟋蟀	鬥蟋蟀
斗话	鬥話
斗艳	鬥豔
斗起	鬥起
斗趣	鬥趣
斗闲气	鬥閒氣
斗鸡	鬥雞
斗雪红	鬥雪紅
斗头	鬥頭
斗风	鬥風
斗饤	鬥飣
斗斗	鬥鬥
斗哄	鬥鬨
斗鱼	鬥魚
斗鸭	鬥鴨
斗鹌鹑	鬥鵪鶉
斗丽	鬥麗
斗龙	鬥龍
闹表	鬧錶
闹钟	鬧鐘
哄动	鬨動
哄堂	鬨堂
哄笑	鬨笑
郁伊	鬱伊
郁勃	鬱勃
郁卒	鬱卒
郁南	鬱南
郁堙不偶	鬱堙不偶
郁塞	鬱塞
郁垒	鬱壘
郁律	鬱律
郁悒	鬱悒
郁闷	鬱悶
郁愤	鬱憤
郁抑	鬱抑
郁挹	鬱挹
郁林	鬱林
郁气	鬱氣
郁江	鬱江
郁沉沉	鬱沉沉
郁泱	鬱泱
郁火	鬱火
郁热	鬱熱
郁燠	鬱燠
郁症	鬱症
郁积	鬱積
郁纡	鬱紆
郁结	鬱結
郁蒸	鬱蒸
郁蓊	鬱蓊
郁血	鬱血
郁邑	鬱邑
郁郁	鬱郁
郁金	鬱金
郁闭	鬱閉
郁陶	鬱陶
郁郁不平	鬱鬱不平
郁郁不乐	鬱鬱不樂
郁郁寡欢	鬱鬱寡歡
郁郁而终	鬱鬱而終
郁郁苍苍	鬱鬱蒼蒼
郁郁葱葱	鬱鬱蔥蔥
郁黑	鬱黑
鬼气冲天	鬼氣衝天
鬼谷子	鬼谷子
魂牵梦系	魂牽夢繫
魏征	魏徵
魔表	魔錶
魔鬼克星	魔鬼克星
鱼干	魚乾
鱼松	魚鬆
鮮于	鮮于
鲜于	鮮于
鲸须	鯨鬚
鳥栖	鳥栖
鸟栖	鳥栖
凤凰于飞	鳳凰于飛
鳳凰于飛	鳳凰于飛
凤梨干	鳳梨乾
鸣钟	鳴鐘
鸿范	鴻範
鹅准	鵝準
鹄发	鵠髮
雕心雁爪	鵰心雁爪
雕悍	鵰悍
雕翎	鵰翎
雕鹗	鵰鶚
鹤峰县	鶴峯縣
鹤吊	鶴弔
鹤发	鶴髮
鸾鉴	鸞鑑
鹰雕	鹰鵰
鹰鵰	鹰鵰
咸、甜	鹹、甜
咸吃	鹹吃
咸味	鹹味
咸嘴淡舌	鹹嘴淡舌
咸土	鹹土
咸度	鹹度
咸得	鹹得
咸批	鹹批
咸水	鹹水
咸派	鹹派
咸海	鹹海
咸淡	鹹淡
咸湖	鹹湖
咸汤	鹹湯
咸潟	鹹潟
咸湿	鹹濕
咸甜	鹹甜
咸的	鹹的
咸粥	鹹粥
咸肉	鹹肉
咸菜	鹹菜
咸菜干	鹹菜乾
咸蛋	鹹蛋
咸猪	鹹豬
咸酥	鹹酥
咸类	鹹類
咸食	鹹食
咸鱼	鹹魚
咸鸭蛋	鹹鴨蛋
咸卤	鹹鹵
咸咸	鹹鹹
盐打怎么咸	鹽打怎麼鹹
盐卤	鹽滷
盐余	鹽餘
鹿場里	鹿場里
麟游	麟遊
麥人杰	麥人杰
麥仁杰	麥仁杰
麦面	麥麵
曲酒	麯酒
曲尘	麴塵
曲櫱	麴櫱
曲秀才	麴秀才
曲车	麴車
曲道士	麴道士
曲钱	麴錢
曲霉	麴黴
麹霉	麴黴
面人儿	麵人兒
面包	麵包
面团	麵團
面坊	麵坊
面坯儿	麵坯兒
面塑	麵塑
面店	麵店
面厂	麵廠
面摊	麵攤
面杖	麵杖
面条	麵條
面汤	麵湯
面浆	麵漿
面疙瘩	麵疙瘩
面皮	麵皮
面码儿	麵碼兒
面筋	麵筋
面粉	麵粉
面糊	麵糊
面缸	麵缸
面肺子	麵肺子
面茶	麵茶
面制品	麵製品
面食	麵食
面饺	麵餃
面饼	麵餅
面馆	麵館
面点、	麵點、
面点师	麵點師
麻将席	麻將蓆
麻酱面	麻醬麵
黄干黑瘦	黃乾黑瘦
黄岩区	黃巖區
黄岩县	黃巖縣
黄历	黃曆
黃杰	黃杰
黄杰	黃杰
黄历史	黃歷史
黄白术	黃白術
黃詩杰	黃詩杰
黄金表	黃金表
黃鈺筑	黃鈺筑
黄钰筑	黃鈺筑
黄钟	黃鐘
黄发	黃髮
黄曲毒素	黃麴毒素
黑奴吁天录	黑奴籲天錄
黑干将	黑幹將
黑长发	黑長髮
黑发	黑髮
点个赞	點個讚
点札	點劄
点半钟	點半鐘
点多钟	點多鐘
点里	點裡
点赞	點讚
点里程	點里程
点钟	點鐘
霉毒	黴毒
霉菌	黴菌
霉黑	黴黑
霉黧	黴黧
鼓里	鼓裡
鼓噪	鼓譟
冬冬鼓	鼕鼕鼓
咚咚鼓	鼕鼕鼓
鼠曲草	鼠麴草
鼻准	鼻準
齐王舍牛	齊王捨牛
齿危发秀	齒危髮秀
齿落发白	齒落髮白
龙岩	龍巖
龙卷	龍捲
龙眼干	龍眼乾
龙须	龍鬚
龙须面	龍鬚麵
龙斗虎伤	龍鬥虎傷
龜山庄	龜山庄
龟鉴	龜鑑
鿒	鿓
，并力	，並力
，并力討	，并力討
，并力讨	，并力討
，个中	，箇中
