定著称	定著称
圞	𪢮
夢著	梦着
園	园
圓	圆
目劄	目劄
圖	图
著緑	着緑
國	国
著緊	着紧
著緋	着绯
將軍抽車	将军抽車
流著述	流著述
圇	囵
圅	函
𩗗	飓
單眼相機	单反相机
億	亿
於除鞬	於除鞬
岳託	岳讬
𩗀	𩙦
爾冬陞	尔冬升
螮	䗖
乾沓和	乾沓和
亁	干
棲	栖
亂	乱
棶	梾
揮著作	挥著作
想著錄	想著录
棡	㭎
訟	讼
榮陞	荣升
棧	栈
亙	亘
么姨	幺姨
亝	斋
雞	鸡
亞	亚
么姓	幺姓
爭著名	争著名
乾步	乾步
棖	枨
棗	枣
縴	纤
瞪著	瞪着
亱	夜
棄	弃
亷	廉
抱著	抱着
棊	棋
亾	亡
澠	渑
鴯	鸸
彞	彝
帶著稱	带著称
雅著述	雅著述
鴨	鸭
鴦	鸯
彙	汇
圍	围
鴣	鸪
籬	篱
白朗寧	勃朗宁
鴿	鸽
渴著名	渴著名
刻著	刻着
鴻	鸿
轉著錄	转著录
鴷	䴕
鴴	鸻
螞	蚂
鴲	𪉆
䞈	𧹑
鴰	鸹
遍佈著	遍布着
鴈	雁
醜著者	丑著者
心著称	心著称
鴇	鸨
躍著稱	跃著称
鴃	𫛞
鎖鍊	锁链
涼著者	凉著者
鴟	鸱
鴜	𪉈
鴝	鸲
鴛	鸳
鴗	𫁡
鴕	鸵
鴒	鸰
螄	蛳
疑著錄	疑著录
信著名	信著名
帳號	账号
㑳	㑇
𧳟	𧳕
𨤻	𨤰
㑶	㐹
麥	麦
制著名	制著名
彎	弯
躊	踌
傳著名	传著名
慫慂	怂恿
渴著書	渴著书
背著名	背著名
陞補	升补
穿著作	穿著作
麩	麸
幫著稱	帮著称
拉著名	拉著名
麪	面
柺	拐
踏著錄	踏著录
乾統	乾统
雍乾	雍乾
晶元	芯片
東	东
蘚	藓
姊姊	姐姐
儌	侥
旋乾轉坤	旋乾转坤
䳘	鹅
嘉芙蓮	凯瑟琳
猜著作	猜著作
酧	酬
西臺族	赫梯族
崍	崃
忍著述	忍著述
朥	𦛨
闇	暗
闆	板
闃	阒
闍	阇
跥	跺
闋	阕
闊	阔
跡	迹
裹著述	裹著述
闖	闯
闕	阙
闔	阖
㩗	携
空氣質素	空气质量
闐	阗
闞	阚
跴	踩
關	关
艾菲爾	埃菲尔
闚	窥
㩜	㨫
隔著書	隔著书
闥	闼
闤	阛
昂著述	昂著述
㩦	携
闡	阐
闠	阓
麼	么
麽	么
扛著作	扛著作
夢著稱	梦著称
腳	脚
乾九	乾九
達著作	达著作
嫻	娴
瞧著作	瞧著作
於菟	於菟
紘	纮
記著者	记著者
酖	鸩
爭著書	争著书
原著	原著
崢	峥
笑著述	笑著述
迫著	迫着
渴著	渴着
紜	纭
盯著作	盯著作
沈船	沉船
藺	蔺
魚乾乾	鱼干干
鷫	鹔
閒	闲
蓀	荪
蓆	席
爭著稱	争著称
帀	匝
矽片	硅片
蓋	盖
擺著稱	摆著称
藹	蔼
帋	纸
名份	名分
乘著者	乘著者
亮著称	亮著称
阿部正瞭	阿部正瞭
敞著名	敞著名
著甚麼	着什么
帥	帅
聹	聍
帬	裙
挑著述	挑著述
蓮	莲
師	师
帶	带
帳	帐
蓴	莼
活著稱	活著称
聽	听
躺著書	躺著书
蒙著	蒙着
六么	六幺
羣	群
收錄著	收录着
騙著錄	骗著录
瞞著錄	瞒著录
朞	期
印著作	印著作
聲	声
暗著稱	暗著称
落著述	落著述
朮	术
蒐羅	搜罗
麼氏	麽氏
朢	望
畫著稱	画著称
朧	胧
程式控制	程控
鐵達尼號	泰坦尼克号
𨥛	𨱀
鐵鍊	铁链
職	职
朶	朵
囙	因
孫乾	孙乾
囓	啮
囑	嘱
留著書	留着书
討	讨
變著稱	变著称
囉	啰
囈	呓
囅	冁
卡斯楚	卡斯特罗
囂	嚣
囁	嗫
囀	啭
恩威並著	恩威并著
想著述	想著述
紼	绋
本著作	本著作
藍芽	蓝牙
造麴	造曲
劄	札
獨立國協	独联体
著綠	着绿
奈及利亞	尼日利亚
威斯伐倫	威斯特法伦
智慧型	智能
八進位制	八进位制
訌	讧
砲	炮
立著	立着
趴著者	趴著者
梘	枧
劃	划
華勒沙	瓦文萨
土魯斯	图卢兹
蕿	萱
蒐集	搜集
雜著述	杂著述
冊	册
樅	枞
開著述	开著述
乾象	乾象
𩯳	𩯒
落著錄	落著录
劚	㔉
幫著作	帮著作
營運長，	首席运营官，
溢著者	溢著者
么蛾子	幺蛾子
厄瓜多	厄瓜多尔
乾氏	乾氏
薴烯	苧烯
髥	髯
不穀	不穀
髮	发
髒	脏
髖	髋
髕	髌
體	体
瞧著書	瞧着书
閤	阁
向著作	向著作
聖	圣
乾竇	乾窦
髈	膀
髏	髅
羈	羁
巋	岿
線國安	缐国安
看著稱	看著称
希特拉	希特勒
偑	㐽
蔕	蒂
蔔	卜
圍著者	围著者
蓋著稱	盖著称
躺著稱	躺著称
蔞	蒌
想著稱	想著称
巗	岩
挑著名	挑著名
裹著名	裹著名
突尼西亞	突尼斯
蔥	葱
蔣	蒋
蔭	荫
巰	巯
坎培拉	堪培拉
巵	卮
跑著書	跑著书
趴著作	趴著作
罵著	骂着
燒	烧
史丹福大學	斯坦福大学
燜	焖
營	营
燙	烫
崑曲	昆曲
燄	焰
燁	烨
乾鵲	乾鹊
站著錄	站著录
尋著	寻着
波札那	博茨瓦纳
懷著述	怀著述
燶	㶶
樫	㭴
燼	烬
燾	焘
攔	拦
燻	熏
頂著述	顶著述
燭	烛
燬	毁
電單車	摩托车
拋	抛
栰	筏
乾陵	乾陵
乾剛	乾刚
哭著名	哭著名
齒	齿
揉著錄	揉著录
於之莹	於之莹
栢	柏
對著述	对著述
動著	动着
逼著作	逼著作
絝	绔
么娘	幺娘
栞	刊
披著書	披著书
釾	䥺
乾陀	乾陀
栁	柳
守著名	守著名
踏著稱	踏著称
揉著述	揉著述
活著作	活著作
樺	桦
盛著作	盛著作
縉	缙
變著	变着
藏著名	藏著名
聽著作	听著作
尋著述	寻著述
漫著稱	漫著称
𠏢	𠉗
拚搏	拚搏
㴱	深
發著者	发著者
坦尚尼亞	坦桑尼亚
𣞻	𣘓
潤著作	润著作
美著述	美著述
照著作	照著作
著呢	着呢
撼著	撼着
鷸	鹬
乾健	乾健
對著錄	对著录
䘚	卒
立著（	立著（
骽	腿
趴著錄	趴著录
䘏	恤
磚	砖
齋	斋
磟	碌
骯	肮
鴞	鸮
站著名	站著名
齊	齐
磧	碛
語著作	语著作
占著	占着
磯	矶
宏都拉斯	洪都拉斯
涼著書	凉著书
乾一壇	乾一坛
磽	硗
關著稱	关著称
𨦫	䦀
踴	踊
旋乾转坤	旋乾转坤
閨	闺
乾蔭	乾荫
大英國協	英联邦
亮著者	亮著者
軟體家具	软体家具
含著錄	含著录
㓂	寇
雅著作	雅著作
瞞著名	瞒著名
擺著	摆着
杴	锨
狂牛症	疯牛病
波士尼亞與赫塞哥維納	波斯尼亚和黑塞哥维那
幫著者	帮著者
許	许
放帳	放账
縗	缞
閂	闩
罩著書	罩著书
註	注
閍	𨸂
閎	闳
閏	闰
閈	闬
閉	闭
開	开
閔	闵
拼著作	拼著作
閐	𨸃
閑	闲
記錄著	记录着
㨗	捷
㑯	㑔
訩	讻
閘	闸
閙	闹
設	设
訓	训
閥	阀
訑	𫍙
訐	讦
車諾比	切尔诺贝利
訖	讫
訕	讪
閣	阁
閬	阆
閭	闾
㨪	晃
記	记
昂著者	昂著者
閩	闽
訝	讶
閫	阃
訃	讣
訂	订
訁	讠
閱	阅
閲	阅
萌島	马恩岛
訊	讯
閾	阈
計	计
鍾情	钟情
乾东	乾东
㨿	据
承乾	承乾
趴著	趴着
齧	啮
逕庭	径庭
擺著作	摆著作
連著稱	连著称
見著作	见著作
𤪺	㻘
貸	贷
拎著錄	拎著录
齪	龊
費	费
鍊鎖	链锁
保障著	保障着
貺	贶
雜著者	杂著者
踩著錄	踩著录
樊於期	樊於期
壓著作	压著作
浮著稱	浮著称
回著	回着
忍著作	忍著作
貰	贳
么小	幺小
高著者	高著者
著名	著名
印著	印着
躶	裸
穿著錄	穿著录
㷿	𤈷
於夫罗	於夫罗
貢	贡
困著作	困著作
來著作	来著作
追著名	追著名
鰷	鲦
索羅門群島	所罗门群岛
瞇	眯
蕆	蒇
蕁	荨
糰	团
嶁	嵝
蕎	荞
嶃	崭
著筆	着笔
做著名	做著名
嶇	岖
蕕	莸
蕒	荬
蕓	芸
暗著書	暗著书
嶔	嵚
蕚	萼
嶗	崂
嶨	峃
蕢	蒉
嶠	峤
蕭	萧
嶢	峣
蕩	荡
蕪	芜
嶧	峄
嶸	嵘
放著名	放著名
嶺	岭
蕷	蓣
嶼	屿
扛著者	扛著者
厄瓜多爾	厄瓜多尔
陰	阴
活著者	活著者
嚙	啮
嚕	噜
藷	薯
嚐	尝
紐幾內亞	新几内亚
乾貴士	乾贵士
嚌	哜
躍著作	跃著作
圍著作	围著作
嚇	吓
嚀	咛
光著書	光著书
柵	栅
嚴	严
擋著作	挡著作
記著書	记著书
點著名	点著名
嚮	向
抓著錄	抓著录
嚨	咙
伊利諾伊	伊利诺伊
嚦	呖
罵著作	骂著作
桺	柳
䴉	鹮
繞著名	绕著名
桿	杆
不著書	不著书
甘比亞	冈比亚
抱著名	抱著名
桮	杯
燒著名	烧著名
騙著稱	骗著称
䴬	𪎈
桒	桑
三極體	三极管
循著	循着
査	查
收帳	收账
漫著作	漫著作
西臺人	赫梯人
𤫩	㻏
鰾	鳔
較著	较著
牽著錄	牵著录
求著	求着
陪著錄	陪著录
纏著錄	缠著录
附著者	附著者
拖著名	拖著名
著甚	着甚
著生	着生
蘇辛尼津	索尔仁尼琴
汶萊	文莱
求著錄	求著录
圍著名	围著名
驥	骥
驤	骧
護著	护着
驦	骦
於志賀	於志贺
昇降	升降
驢	驴
麼著	么着
睡著錄	睡著录
驫	骉
驪	骊
驕	骄
𦪽	𦨩
驗	验
驟	骤
碭	砀
碪	砧
驘	骡
驛	驿
碩	硕
驅	驱
驄	骢
驁	骜
不著錄	不著录
驃	骠
驂	骖
著題	着题
驌	骕
碼	码
碽	䂵
確	确
拉著稱	拉著称
因著作	因著作
驊	骅
阿拉伯聯合大公國	阿拉伯联合酋长国
笑著稱	笑著称
轍	辙
熒	荧
熓	𤆡
行人路權	行人路权
堅貞著	坚贞着
望著作	望著作
熈	熙
熉	𤈶
熌	𤇄
跳著稱	跳著称
牽著稱	牵著称
熅	煴
熾	炽
熲	颎
熱	热
哭著者	哭著者
撼著稱	撼著称
辦著錄	办著录
熡	𤋏
臨著者	临著者
詰	诘
話	话
該	该
詳	详
鋭	锐
詵	诜
詶	酬
巨著	巨著
詼	诙
駶	𩧺
詿	诖
詠	咏
坐著稱	坐著称
詢	询
詣	诣
都卜勒	多普勒
轂	毂
試	试
慟	恸
詩	诗
詫	诧
詬	诟
詭	诡
詮	诠
詐	诈
詒	诒
詔	诏
評	评
詖	诐
加薩走廊	加沙地带
詘	诎
詛	诅
詞	词
詀	𧮪
詁	诂
記著錄	记著录
颶	飓
詆	诋
猜著述	猜著述
膠著	胶着
鯫	鲰
慙	惭
長	长
榿	桤
乾闼	乾闼
喬治·歐威爾	乔治·奥威尔
么媽	幺妈
榲	榅
達文西	达芬奇
榮	荣
畫著作	画著作
乾闥	乾闼
入帳	入账
挨剋	挨剋
捆著	捆着
佛頭著糞	佛头著粪
全球資訊網	万维网
無	无
騙著述	骗著述
提比里西	第比利斯
衣著書	衣著书
暗著述	暗著述
可穿著	可穿著
襠	裆
鎗	枪
倒帳	倒账
敞著稱	敞著称
巴塞隆納	巴塞罗那
跑著稱	跑著称
尋著作	寻著作
鬥著書	斗著书
順著錄	顺著录
明白帳	明白账
保障著者	保障著者
駰	骃
顯示卡	显卡
吹著作	吹著作
㒺	罔
悞	悮
鯒	鲬
利欲薰心	利欲薰心
轢	轹
悅	悦
𨧱	𨱊
轣	𫐆
網路	网络
亚细安	东盟
㒓	𠉂
鎇	镅
悶	闷
點著述	点著述
拉著述	拉著述
爐	炉
悽	凄
皺著作	皱著作
叫著書	叫著书
悤	匆
於宇同	於宇同
樂著者	乐著者
住著名	住著名
闌	阑
噥	哝
䛐	词
噦	哕
噯	嗳
噲	哙
噴	喷
噹	当
噸	吨
闈	闱
藉機	借机
作業系統	操作系统
噅	𠯠
高陞	高升
噉	啖
動著稱	动著称
鎻	锁
尼乾陀	尼乾陀
仗著	仗着
噓	嘘
鯁	鲠
聽著名	听著名
闓	闿
噚	㖊
噝	咝
格瑞那達	格林纳达
闒	阘
黏著稱	黏著称
誶	谇
打著書	打著书
身著	身着
課	课
誼	谊
調	调
誾	訚
誹	诽
㪚	散
誤	误
誦	诵
誡	诫
㪟	敦
誣	诬
拼著述	拼著述
健力士世界紀錄	吉尼斯世界纪录
説	说
攜	携
誨	诲
說	说
誕	诞
誖	悖
誑	诳
誒	诶
乾乾	乾乾
語	语
悠著名	悠著名
誚	诮
誅	诛
誄	诔
誇	夸
誆	诓
陋著名	陋著名
誌	志
証	证
鎩	铩
巨集	宏
西元8	公元8
釀著作	酿著作
筆帳	笔账
㠯	以
李乾德	李乾德
映著者	映著者
寫著書	写著书
與著稱	与著称
趴著稱	趴著称
非同步	异步
闢	辟
𨄣	𨀱
乾貺	乾贶
潯	浔
片語	词组
衣著錄	衣著录
忍著者	忍著者
箇	个
𥌃	𥅘
薈	荟
薊	蓟
薌	芗
癆	痨
薀	蕰
想著	想着
癅	瘤
疇	畴
薘	荙
行著名	行著名
薟	莶
鄧	邓
薑	姜
嫋	袅
嵗	岁
親	亲
薔	蔷
薩	萨
㩳	㧐
么雞	幺鸡
夢著書	梦著书
行餘	行馀
薦	荐
嵼	𡶴
猜著	猜着
鰌	䲡
持著者	持著者
薴	苧
福馬林	福尔马林
灝	灏
霽	霁
發著《	发著《
關著名	关著名
灙	𣺼
島	岛
保障著書	保障著书
灕	漓
櫓	橹
樂著作	乐著作
𡨥	寇
乾為天	乾为天
灋	法
關係著	关系着
枕著者	枕著者
山崎闇齋	山崎闇斋
䀹	𥅴
灃	沣
陞任	升任
災	灾
揉著作	揉著作
築	筑
矛盾著	矛盾着
溼	湿
管著名	管著名
抱著者	抱著者
灩	滟
灧	滟
蠟	蜡
灤	滦
灣	湾
象徵著	象征着
灠	漤
幫浦	泵
嘮	唠
潤著	润着
官陞	官升
嘩	哗
吉力馬札羅	乞力马扎罗
嘵	哓
嘰	叽
愛著述	爱著述
衣著者	衣著者
忍著錄	忍著录
嘽	啴
拿著述	拿著述
顯著地	显著地
嘸	呒
矽肺	矽肺
嘆	叹
溫	温
杜塞道夫	杜塞尔多夫
嘅	慨
著書立說	著书立说
嘍	喽
膠著者	胶著者
應用程式	应用程序
諲譔	諲譔
嘗	尝
若且唯若	当且仅当
連著書	连著书
嘓	啯
嘑	呼
龍鍾	龙钟
塞拉利昂	塞拉利昂
著抹	着抹
溮	浉
槼	椝
癧	疬
乾鈞	乾钧
䶊	衄
𪘯	𪚐
槶	椢
躍著述	跃著述
槳	桨
擋著述	挡著述
槮	椮
槨	椁
著録	着録
乾沓婆	乾沓婆
槤	梿
槧	椠
恰如其份	恰如其分
盯著錄	盯著录
著錄	著录
癡	痴
𪘀	𪚏
克羅埃西亞	克罗地亚
本著者	本著者
槓	杠
借著	借着
槍	枪
臨著述	临著述
辦著作	办著作
構	构
區域網路	局域网络
李奧納多	列奥那多
騸	骟
騾	骡
筍	笋
轉著名	转著名
騰	腾
騶	驺
騷	骚
騪	𩨄
騫	骞
騮	骝
筞	策
姊弟	姐弟
騭	骘
成份	成分
騣	鬃
帳本	账本
衣索比亞	埃塞俄比亚
騧	䯄
騤	骙
美著錄	美著录
結帳	结账
嫿	婳
筩	筒
騙	骗
筯	箸
騟	𩨈
騝	𩨃
騐	验
叫著稱	叫著称
乾晖	乾晖
騔	𩨀
騎	骑
騏	骐
騌	骔
壓著述	压著述
騂	骍
騃	𫘤
騁	骋
遇著書	遇著书
站著述	站著述
睡著稱	睡著称
著跡	着迹
維德角	佛得角
塤	埙
語著述	语著述
㕥	以
保護著	保护着
嫵	妩
信著書	信著书
惏	婪
膠著作	胶著作
沉著者	沉著者
人工智慧	人工智能
㕑	厨
惷	蠢
斥著述	斥著述
惻	恻
雷伊泰灣	莱特湾
包著	包着
㕘	参
惡	恶
懷著	怀着
蔡孝乾	蔡孝乾
惥	恿
㕁	却
展著錄	展著录
藏著	藏着
瀝	沥
瀟	潇
瀘	泸
黏著名	黏著名
瀕	濒
荷里活	好莱坞
瀏	浏
瀉	泻
賴帳	赖账
瀅	滢
瀆	渎
苦著	苦着
拼著名	拼著名
瀃	𣽷
瀾	澜
代表著錄	代表著录
瀰	弥
瀲	潋
裹著稱	裹著称
瀨	濑
瀦	潴
瀧	泷
瀠	潆
么叔	幺叔
諺	谚
鋒	锋
諸	诸
努力著作	努力著作
諼	谖
著床	着床
諳	谙
諰	𫍰
諱	讳
諶	谌
諷	讽
賴比瑞亞	利比里亚
機	机
跟著	跟着
鋂	镅
鋁	铝
塊	块
諮	谘
鋅	锌
諭	谕
諢	诨
李乾顺	李乾顺
鋉	𨱈
諡	谥
諦	谛
諧	谐
諤	谔
鋌	铤
諛	谀
鋱	铽
鋰	锂
諞	谝
鋶	锍
諜	谍
公尺	米
諒	谅
諑	诼
論	论
諗	谂
鋼	钢
鋣	铘
請	请
伊波拉	埃博拉
諉	诿
著庸	着庸
鋥	锃
鋤	锄
諂	谄
鋪	铺
鋩	铓
鋨	锇
陪著者	陪著者
談	谈
受著名	受著名
論著	论著
帳簿	账簿
著涼	着凉
管著稱	管著称
披著作	披著作
碩託	硕讬
圍著	围着
嚲	亸
瀋液	渖液
蘭卡威	浮罗交怡
因著	因着
釀著稱	酿著称
老么	老幺
劏	㓥
乾儀	乾仪
鋪著稱	铺著称
庇里牛斯	比利牛斯
外掛程式	插件
寫著述	写著述
兒寬	兒宽
數位化	数字化
為著《	为著《
們	们
沙地阿拉伯	沙特阿拉伯
偷著者	偷著者
坎城	戛纳
如瀋	如渖
𩏪	𩏽
藍	蓝
崗	岗
著落	着落
遡	溯
悠著稱	悠著称
孙乾	孙乾
於之瑩	於之莹
藝	艺
著節	着节
暗著錄	暗著录
纏著	缠着
汚	污
藭	䓖
藪	薮
藥	药
閉著書	闭著书
藼	萱
空著	空着
定著作	定著作
藶	苈
希冀著	希冀着
藴	蕴
贓	赃
崬	岽
𣾷	㳢
借著錄	借著录
海洛英	海洛因
梳著作	梳著作
有著者	有著者
蒐采	搜采
飿	饳
斥著稱	斥著称
遷	迁
下著者	下著者
怱	匆
怳	恍
釐清	厘清
拉著作	拉著作
於乙于同	於乙于同
裝著名	装著名
衣著	衣着
嗩	唢
櫸	榉
受著錄	受著录
錳	锰
嗹	𪡏
蓡	参
趕著	赶着
嗶	哔
嗊	唝
乾罗	乾罗
嗎	吗
倲	㑈
嗁	啼
嗇	啬
嗆	呛
追著書	追著书
𤁣	𣺽
嗚	呜
懷著稱	怀著称
網際網路	互联网
皺著述	皱著述
班傑明	本杰明
兩	两
躺著錄	躺著录
螢幕	屏幕
𩣑	䯃
𨅍	𨁴
蓯	苁
𩣏	𩧶
𧜗	䘞
情鍾	情钟
溈	沩
膢	𦝼
𩣺	𩧼
𩣵	𩧻
著疑	着疑
來著名	来著名
兠	兜
本著稱	本著称
乾宅	乾宅
鯿	鳊
鯽	鲫
踏著名	踏著名
䛡	话
坐著書	坐著书
鯶	𩽼
鯴	鲺
吹著述	吹著述
鯱	𩾇
鯰	鲶
索忍尼辛	索尔仁尼琴
鯪	鲮
東南亞國家協會	东南亚国家联盟
鯨	鲸
鯧	鲳
鯤	鲲
共和联邦	英联邦
鯡	鲱
疑著	疑着
鯛	鲷
拼著錄	拼著录
鯗	鲞
鯖	鲭
鯕	鲯
鯔	鲻
幫著錄	帮著录
靭	韧
亞塞拜然	阿塞拜疆
鯊	鲨
鯉	鲤
鯇	鲩
鯆	𫚙
蓽	荜
兗	兖
下著名	下著名
鯀	鲧
䉬	𫂈
夥計	伙计
舖	铺
讎校	雠校
𩎢	𩏾
峝	峒
舘	馆
硃砂	朱砂
與	与
應著書	应著书
舊	旧
舉	举
興	兴
領著名	领著名
撼著名	撼著名
陳禕	陳禕
峴	岘
峽	峡
高昇	高升
著著	着着
校讎	校雠
顯著地位	显著地位
印著名	印著名
殺著	杀着
畫著名	画著名
矽鋼	矽钢
辛巴威	津巴布韦
會	会
厀	膝
靠著名	靠著名
於于同	於于同
米泽瑠美	米泽瑠美
𡮣	𡭬
濇	涩
烴	烃
瞪著名	瞪著名
候著述	候著述
拎著	拎着
味著書	味著书
銠	铑
仲介	中介
醜著述	丑著述
臨著	临着
烏	乌
映著錄	映著录
敞著作	敞著作
烖	灾
𡮉	𡭜
唄	呗
閉著名	闭著名
展著稱	展著称
福著錄	福著录
浮著名	浮著名
乾樞	乾枢
陪著作	陪著作
立著名	立著名
沖著	冲着
欄位	字段
軟碟機	软驱
敞著錄	敞著录
響著稱	响著称
記著作	记著作
趕著錄	赶著录
制著稱	制著称
沿著作	沿著作
機率	概率
跑著錄	跑著录
下著錄	下著录
椏	桠
著淺	着浅
盛著	盛着
椗	碇
庫德人	库尔德人
著作	著作
接著者	接著者
同陞和	同升和
強	强
乾元	乾元
算帳	算账
三蘭港	达累斯萨拉姆
雅穆索戈	亚穆苏克罗
乾光	乾光
對著稱	对著称
活著錄	活著录
椲	㭏
流動網絡	移动网络
椷	缄
椶	棕
流著書	流著书
椾	笺
聽著稱	听著称
映著作	映著作
篋	箧
放著稱	放著称
晶片	芯片
鮶	鲪
乾兴	乾兴
鮰	𫚔
節	节
崑崙	昆仑
罵著述	骂著述
鮭	鲑
鮮	鲜
篘	𥬠
篛	箬
鮫	鲛
篔	筼
鮦	鲖
哭著錄	哭著录
含著述	含著述
兇	凶
鮜	鲘
鮝	鲞
鮞	鲕
鮟	𩽾
篩	筛
鮚	鲒
斥著作	斥著作
釐訂	厘订
篤	笃
鮐	鲐
衣索匹亞	埃塞俄比亚
鮒	鲋
鮓	鲊
鮍	鲏
鮎	鲇
鮊	鲌
鮋	鲉
鮄	𫚒
鮁	鲅
篳	筚
罩著錄	罩著录
㗲	𠵾
憐	怜
沉著錄	沉著录
抬著稱	抬著称
紮著名	扎著名
懸	悬
澈底	彻底
麗著述	丽著述
曨	昽
殺著者	杀著者
數著	数着
鰳	鳓
動著名	动著名
豓	艳
曬	晒
恠	怪
恡	吝
華里沙	瓦文萨
恥	耻
謾	谩
蒲隆地	布隆迪
候著	候着
謹	谨
乗	乘
銘	铭
銚	铫
銛	铦
謳	讴
銀	银
鰺	鲹
枕著稱	枕著称
走著者	走著者
謫	谪
銅	铜
謨	谟
匯流排	总线
蘋果	苹果
銍	铚
謡	谣
謠	谣
銱	铞
李乾順	李乾顺
銳	锐
講	讲
撥	拨
㬪	叠
銷	销
謗	谤
謖	谡
銻	锑
銼	锉
謐	谧
象徵著名	象征著名
謎	谜
𧝞	䘛
謌	歌
當著述	当著述
銦	铟
沈積	沉积
銨	铵
銩	铥
謅	诌
謄	誊
銬	铐
謂	谓
謁	谒
謀	谋
寃	冤
住著書	住著书
寀	采
標志著	标志着
瞪著稱	瞪著称
寑	寝
達著	达着
學著	学着
考著名	考著名
立著称	立著称
𩢾	𩧮
寧	宁
實	实
撲	扑
寫	写
逕往	径往
愛著稱	爱著称
𩢴	𩧵
萬那杜	瓦努阿图
蘭	兰
考著	考着
寳	宝
囌	苏
樂著述	乐著述
寶	宝
寵	宠
陸徵祥	陆徵祥
乙太網	以太网
𩢡	𩧬
么孃	幺娘
低著	低着
德希達	德里达
舒麥加	舒马赫
跪著作	跪著作
領著	领着
楊	杨
吉布地	吉布提
乾务	乾务
么子	幺子
象牙海岸	科特迪瓦
趕著名	赶著名
溳	涢
清帳	清账
曾運乾	曾运乾
萊	莱
看著錄	看著录
楥	楦
鮺	鲝
乾劉	乾刘
笑著書	笑著书
伴著書	伴著书
業	业
硬碟	硬盘
鰐	鳄
楨	桢
陋著書	陋著书
飽託	饱讬
範	范
艙	舱
帳面	账面
護著者	护著者
黛安娜	戴安娜
閉著述	闭著述
朝著稱	朝著称
瞞著作	瞒著作
鮳	鲓
𠞰	剿
艱	艰
鳾	䴓
艷	艳
𠞆	𠛆
蒲朗克	普朗克
於崇文	於崇文
艢	樯
艣	橹
艤	舣
岡	冈
艦	舰
下著稱	下著称
艪	橹
艫	舻
閒著	闲着
賴索托	莱索托
晃著	晃着
喪	丧
守著錄	守著录
存著作	存著作
鮪	鲔
單	单
颭	飐
動著者	动著者
袞	衮
乾泉水	干泉水
叫著作	叫著作
低著錄	低著录
喲	哟
夾著者	夹著者
響著作	响著作
鹵	卤
扛著錄	扛著录
䌥	𦈠
喎	㖞
北韓	北朝鲜
士多啤梨	草莓
丟	丢
跟著稱	跟著称
組份	组分
乾羅	乾罗
乾嘉	乾嘉
鮣	䲟
囪	囱
近角聪信	近角聪信
鷂	鹞
燒著錄	烧著录
浮著者	浮著者
綁著名	绑著名
住著錄	住著录
西臺帝	赫梯帝
聞	闻
臨著作	临著作
𠕂	再
撟	挢
賭	赌
二進位制	二进位制
學著者	学著者
浮著錄	浮著录
撝	㧑
循著作	循著作
疑著作	疑著作
辦著述	办著述
戰著書	战著书
宂	冗
緓	绬
饘	𫗴
𨇁	𧿈
於戏	於戏
鮑	鲍
困著名	困著名
戴著錄	戴著录
於志贺	於志贺
𨈊	𨂺
慣著錄	惯著录
𨇞	𨅫
映著稱	映著称
𩡺	𩧦
䝻	𧹕
天道为乾	天道为乾
藉手	借手
美著	美着
滑鼠蛇	滑鼠蛇
緘	缄
辢	辣
編著	编著
周易乾	周易乾
乾覆	乾覆
箒	帚
印著稱	印著称
饒	饶
待著稱	待著称
騙著	骗着
顯著特點	显著特点
鳶	鸢
用著作	用著作
箋	笺
厄利垂亞	厄立特里亚
有著錄	有著录
箏	筝
厄利垂亚	厄立特里亚
緣	缘
著魔	着魔
陋著述	陋著述
箠	棰
甜著作	甜著作
晃著錄	晃著录
鮃	鲆
急著作	急著作
饌	馔
華倫西亞	巴伦西亚
䌈	𦈖
刻著称	刻著称
梳著	梳着
仗著錄	仗著录
駛著	驶着
夢著作	梦著作
託恩多	讬恩多
演算法	算法
西維爾	塞维利亚
於梨華	於梨华
䪗	𩐀
為著者	为著者
為	为
布殊	布什
䬝	𩙯
康乾	康乾
乾為陽	乾为阳
於潜	於潜
於梨华	於梨华
傭	佣
東協助	东协助
䌖	𦈜
管帳	管账
譽	誉
厄立特里亞	厄立特里亚
強斯頓環礁	约翰斯顿岛
譸	诪
乾定	乾定
繫	系
護	护
議	议
挨著稱	挨著称
鉛	铅
繪	绘
鉅	钜
向著名	向著名
譯	译
鉁	𨱅
鉀	钾
譫	谵
鉍	铋
𧜵	䙊
乾安	乾安
鉉	铉
鉈	铊
胺基酸	氨基酸
頂著者	顶著者
布吉納法索	布基纳法索
譟	噪
著帳	着帐
譙	谯
鉳	锫
鉲	锎
譔	撰
䌟	𦈞
譖	谮
制著書	制著书
鉻	铬
戰著名	战著名
譌	讹
鉤	钩
譎	谲
譏	讥
證	证
傳著作	传著作
鉢	钵
鉭	钽
鉬	钼
傒倖	傒倖
紮著作	扎著作
㯭	橹
譁	哗
亞歷山卓	亚历山大
付帳	付账
朴於宇同	朴於宇同
伊斯坦堡	伊斯坦布尔
天道為乾	天道为乾
唱著述	唱著述
乾一組	乾一组
䱙	𩾈
追著者	追著者
載著作	载著作
掙	挣
雅著錄	雅著录
有著名	有著名
騎著者	骑著者
䱰	𩾋
瘂	痖
洗鍊	洗练
偷著名	偷著名
走為上著	走为上着
載著者	载著者
掄	抡
答覆	答复
線姓	缐姓
卯足	铆足
揉著稱	揉著称
勑	敕
衂	衄
配著名	配著名
因著名	因著名
檉	柽
順著者	顺著者
瑽	𪻐
隨著者	随著者
沉著	沉着
檁	檩
繅	缫
瘉	愈
記著述	记著述
檟	槚
檜	桧
溢著稱	溢著称
附著	附着
檯	台
檮	梼
美著名	美著名
翁山蘇姬	昂山素季
檣	樯
檢	检
衚	胡
紐澤西	新泽西
檻	槛
繏	𦈝
檸	柠
乾務	乾务
李澤鉅	李泽钜
檳	槟
身著作	身著作
尖峰時段	高峰时段
玩著	玩着
憚	惮
轉殖	克隆
用著稱	用著称
過著	过着
瘓	痪
憒	愦
憑	凭
隨著	随着
乾岗	乾岗
憊	惫
鵚	𪉍
憇	憩
魘	魇
魛	鱽
魚	鱼
憂	忧
魟	𫚉
么鳳	幺凤
希拉蕊	希拉里
躺著述	躺著述
乾岡	乾冈
霍爾斯坦	荷尔斯泰因
魨	鲀
憲	宪
魯	鲁
伺服器	服务器
憮	怃
追著錄	追著录
魴	鲂
魷	鱿
躍著名	跃著名
憤	愤
著手	着手
繐	穗
啣	衔
啢	唡
瓦倫西亞	巴伦西亚
動著述	动著述
賓士	奔驰
問	问
啎	忤
山崎闇斋	山崎闇斋
啟	启
啞	哑
繙	翻
豎著稱	竖著称
𩥇	𩨍
倖田	倖田
啗	啖
啑	喋
遶境	绕境
騎著名	骑著名
沿著述	沿著述
𢣚	𢘝
媧	娲
鈞	钧
著志	着志
配著錄	配著录
鈒	钑
鈐	钤
著忙	着忙
龭	𩨎
開著	开着
鈕	钮
鏗	铿
著心	着心
鈈	钚
銓	铨
鈎	钩
鈍	钝
鈃	钘
鈀	钯
鈁	钫
鈇	𫓧
鈄	钭
㬉	暖
打著	打着
鈸	钹
鈹	铍
揉著	揉着
鈿	钿
藉著	借着
鈽	钸
鈲	𨱃
鈳	钶
鈰	铈
鈷	钴
向著	向着
年陞	年升
逆著作	逆著作
演著者	演著者
刻著作	刻著作
鈯	𨱄
乾寧	乾宁
沈重	沉重
傳著錄	传著录
鈣	钙
鈠	𨱁
鈦	钛
鈧	钪
鈥	钬
讁	谪
讀	读
瘲	疭
孃	娘
關帳	关账
孌	娈
讋	詟
變	变
讌	䜩
孋	㛤
讎	仇
𩠴	𩠠
讓	让
蹣	蹒
讕	谰
讖	谶
印著者	印著者
回著名	回著名
讜	谠
蘸著書	蘸著书
讞	谳
伯明罕	伯明翰
沈著	沉着
孫	孙
逆著	逆着
戀著	恋着
飢	饥
尋著名	寻著名
成績顯著	成绩显著
孿	孪
學	学
屛	屏
抬著者	抬著者
屜	屉
穀水	穀水
反反覆覆	反反复复
做著作	做著作
鱼雷	鱼雷
屍	尸
屆	届
潤著者	润著者
餬口	糊口
受著者	受著者
芲	花
載著書	载著书
芻	刍
屩	𪨗
飄著名	飘著名
陪著述	陪著述
屬	属
屢	屡
绑紧跳	蹦极跳
層	层
獫	猃
獪	狯
繞著述	绕著述
獨	独
獮	狝
厭	厌
騎著錄	骑著录
獧	狷
謝	谢
獻	献
獺	獭
潿	涠
獸	兽
行政總裁	首席执行官
住著稱	住著称
獲	获
瀂	澛
獰	狞
獷	犷
蹺	跷
關著書	关著书
謚	谥
獎	奖
葛摩	科摩罗
獃	呆
獁	犸
努力著名	努力著名
獅	狮
定著書	定著书
術	术
谢肇淛	谢肇淛
瞭台	瞭台
獘	毙
過著名	过著名
經常帳	经常账
名著	名著
謔	谑
賴	赖
土著	土著
唸	念
著文	著文
躊躇滿志	踌躇滿志
簍	篓
乾縣	乾县
聽著者	听著者
音樂錄影帶	音乐录影带
於姓	於姓
住著	住着
陈乾生	陈乾生
濜	浕
唕	唣
唚	吣
唘	启
拚死	拚死
綁著述	绑著述
擋著稱	挡著称
購	购
賽普勒斯	塞浦路斯
瞞著	瞒着
效果顯著	效果显著
急著者	急著者
絃	弦
終	终
高畫質	高清
聖吉斯納域斯	圣基茨和尼维斯
絆	绊
絅	䌹
組	组
來著稱	来著称
絏	绁
絎	绗
跪著稱	跪著称
結	结
借著者	借著者
羅亞爾	卢瓦尔
糉	粽
抱著錄	抱著录
陋著稱	陋著称
資	资
絢	绚
撼著書	撼著书
銫	铯
給	给
一釐	一厘
䲰	𪉂
䪏	𩏼
絨	绒
絳	绛
絲	丝
鋪著錄	铺著录
絰	绖
絶	绝
絺	𫄨
絹	绢
板著臉	板着脸
待著錄	待著录
跪著述	跪著述
達著者	达著者
塞拉耶佛	萨拉热窝
涖	莅
穎	颖
積	积
穌	稣
含著作	含著作
窮	穷
餘瀋	馀渖
忙著	忙着
穽	阱
裝著稱	装著称
巖	岩
擋著	挡着
語著稱	语著称
形上學	形而上学
穡	穑
穠	秾
穭	稆
附著名	附著名
穫	获
穩	稳
穨	颓
桌上型電腦	台式电脑
懟	怼
剋了	剋了
鬀	剃
蔦	茑
說著者	说著者
應著名	应著名
叢	丛
低著稱	低著称
揉著名	揉著名
懌	怿
懍	懔
鏈	链
響著述	响著述
盛著名	盛著名
應	应
懇	恳
懀	𢙓
爭著述	争著述
鬦	斗
漫著	漫着
懾	慑
鬥	斗
鬢	鬓
懺	忏
待覆	待复
懶	懒
逕	迳
躺著者	躺著者
鬨	哄
鬩	阋
懨	恹
瞪著作	瞪著作
試著稱	试著称
鬱	郁
鬹	鬶
猨	猿
初昇	初升
踏著	踏着
猻	狲
介面	界面
蕘	荛
䮞	𩨁
猶	犹
䮠	𩧿
猂	悍
頂著錄	顶著录
亮著作	亮著作
猙	狰
涼	凉
䮳	𩨏
弳	弪
䮾	𩧪
遇著名	遇著名
冒著書	冒著书
鏟	铲
鏞	镛
鏝	镘
鏜	镗
鏚	戚
寢	寝
信著者	信著者
財務長、	首席财务官、
16進位	16进制
考著稱	考著称
乾心	乾心
鏑	镝
叫著	叫着
鏍	镙
鏌	镆
鏉	𨱒
㡌	帽
鏇	镟
鏆	𨱌
鏃	镞
逈	迥
疑著名	疑著名
黃麴毒素	黄曲毒素
鏽	锈
配著者	配著者
鏺	䥽
鏹	镪
鏷	镤
福著	福着
鏵	铧
𩢸	𩧳
愛著名	爱著名
劃著	划着
鏰	镚
睡著作	睡著作
騎著稱	骑著称
鏦	𫓩
煞車	刹车
傳著述	传著述
審	审
鏡	镜
蟣	虮
櫈	凳
護著作	护著作
櫃	柜
櫚	榈
櫛	栉
櫝	椟
櫞	橼
藉詞	借词
公釐	毫米
乾贶	乾贶
蟬	蝉
疑著述	疑著述
空著者	空著者
櫫	橥
信著錄	信著录
乾鵠	乾鹄
櫥	橱
櫧	槠
乾刘	乾刘
乾刚	乾刚
櫻	樱
傳著	传着
揮著	挥着
櫳	栊
尟	鲜
𩗡	𩙧
尙	尚
尒	尔
禪	禅
合著	合著
導	导
對	对
見著名	见著名
尋	寻
專	专
鈑	钣
將	将
沉著稱	沉著称
尅	克
殺著錄	杀著录
疑著稱	疑著称
尷	尴
見	见
濺	溅
綁著者	绑著者
苧	苎
尠	鲜
流著稱	流著称
𨽻	隶
乾封	乾封
飈	飚
規	规
飃	飘
愨	悫
用著述	用著述
飆	飙
飄	飘
飛	飞
變著名	变著名
著體	着体
飜	翻
愽	博
愾	忾
飫	饫
受著書	受著书
飩	饨
飯	饭
喝著錄	喝著录
飭	饬
飣	饤
燉	炖
衣著作	衣著作
飠	饣
著墨	着墨
飥	饦
燈	灯
鈔	钞
淒	凄
飾	饰
飽	饱
飼	饲
飲	饮
飱	飧
捆著述	捆著述
愜	惬
於潛縣	於潜县
哶	咩
占著名	占著名
飛昇	飞升
所鍾	所钟
裝著書	装著书
陪著	陪着
流著	流着
動著作	动著作
哯	𠯟
覽	览
憑藉	凭借
負著	负着
數位技術	数字技术
試著	试着
得著稱	得著称
嚷著名	嚷著名
覆蓋	覆盖
醜著書	丑著书
順著書	顺著书
嬈	娆
映著	映着
嬌	娇
嬃	媭
嬀	妫
愛著者	爱著者
嬙	嫱
易經·乾	易经·乾
嬝	袅
覆检	复检
鍤	锸
嬪	嫔
衺	邪
𩧆	𩨐
網頁連結	网页链接
沉著述	沉著述
非份	非分
嬡	嫒
嬤	嬷
嬸	婶
隔著	隔着
嬾	懒
配著稱	配著称
罩著者	罩著者
嬰	婴
𩚵	𩠁
甜著述	甜著述
唱著者	唱著者
展著名	展著名
鈉	钠
稟	禀
財務長，	首席财务官，
䗿	𧉞
甚麼	什么
甚麽	什么
稅	税
獲著錄	获著录
稏	䅉
稈	秆
稉	粳
䗬	蜂
乾钧	乾钧
跑著述	跑著述
稱	称
當著錄	当著录
覥	觍
稾	稿
蕭士塔高維奇	肖斯塔科维奇
崑山	昆山
施讎	施雠
急著述	急著述
耀著名	耀著名
受著稱	受著称
稭	秸
種	种
掙著作	挣著作
繞著作	绕著作
努力著称	努力著称
淩	凌
𪄕	𪉒
空著錄	空著录
吉里巴斯	基里巴斯
揉著書	揉著书
儲	储
叄	叁
茲	兹
極	极
遇著稱	遇著称
沿著者	沿著者
背著述	背著述
𠌥	𠆿
鍁	锨
陞用	升用
釐改	厘改
䯀	䯅
保障著稱	保障著称
現	现
匟	炕
儸	㑩
鍄	𨱉
簑	蓑
磁碟	磁盘
附著述	附著述
鍆	钔
苦著作	苦著作
乾和	乾和
紀	纪
紂	纣
類	类
約	约
紅	红
紆	纡
紇	纥
紈	纨
紉	纫
紋	纹
納	纳
陳遇乾	陈遇乾
趕著稱	赶著称
紓	纾
純	纯
紕	纰
紖	纼
紗	纱
做著述	做著述
紙	纸
級	级
紛	纷
管著錄	管著录
紝	纴
紡	纺
又陞	又升
紥	扎
暗著名	暗著名
紬	䌷
紮	扎
細	细
紱	绂
紲	绁
紳	绅
紵	纻
紹	绍
紺	绀
柯德莉·夏萍	奥黛丽·赫本
渴著稱	渴著称
行著作	行著作
有著述	有著述
載著稱	载著称
陸	陆
凱薩琳	凯瑟琳
抱著稱	抱著称
樁	桩
樂	乐
樞	枢
標	标
鍘	铡
傅利葉	傅里叶
對著	对着
樑	梁
樓	楼
戴著述	戴著述
閑著錄	闲著录
岅	坂
幫著名	帮著名
著法	着法
樣	样
循著書	循著书
肅	肃
觔斗	斤斗
樹	树
樸	朴
智慧手機	智能手机
滾	滚
沈澱	沉淀
做著錄	做著录
樳	桪
乾贞	乾贞
竚	伫
竝	并
竈	灶
竊	窃
藉端	借端
查維茲	查韦斯
信著作	信著作
竅	窍
竄	窜
竇	窦
過著作	过著作
滄	沧
跑著者	跑著者
站著書	站著书
競	竞
臨著名	临著名
溢著錄	溢著录
竪	竖
悵	怅
抓著者	抓著者
竢	俟
心著作	心著作
慤	悫
仗著名	仗著名
慣	惯
慮	虑
狄托	铁托
乾居	乾居
奈洛比	内罗毕
慪	怄
慫	怂
萧乾	萧乾
慶	庆
慴	慑
慳	悭
空氣品質	空气质量
慾	欲
釀著書	酿著书
慽	戚
𡓾	𡋀
說著作	说著作
風	风
慄	栗
駕著名	驾著名
區域網	局域网
颮	飑
颯	飒
慍	愠
態	态
颸	飔
颺	飏
颻	飖
颼	飕
颾	𩙫
颰	𩙥
颱	台
發著作	发著作
颳	刮
慚	惭
蕭士達高維契	肖斯塔科维奇
颷	𩙪
鎝	𨱏
鎘	镉
份量	分量
鎚	锤
鎛	镈
鎔	镕
遇著述	遇著述
鎖	锁
借著名	借著名
豎著	竖着
鎌	镰
走著作	走著作
分佈著	分布着
立著《	立著《
鎊	镑
㠏	㟆
鎄	锿
滷	卤
衝著	冲着
雅著	雅着
鎂	镁
陈遇乾	陈遇乾
鎿	镎
鎸	镌
提著述	提著述
鎵	镓
鎷	𨰾
鎰	镒
鎲	镋
鎳	镍
鎬	镐
鎭	镇
鎮	镇
鎯	𨱍
扛著稱	扛著称
殺著述	杀著述
含著名	含著名
鎦	镏
鎧	铠
鎡	镃
鎢	钨
鎣	蓥
蠏	蟹
蠍	蝎
蘸著者	蘸著者
蠁	蚃
蠆	虿
蠅	蝇
流著者	流著者
仗著者	仗著者
嫗	妪
要帳	要账
蠑	蝾
蠐	蛴
覆核	复核
私帳	私账
蠔	蚝
蠨	蟏
蠭	蜂
蠣	蛎
蠻	蛮
站著稱	站著称
嫺	娴
逆著述	逆著述
蠱	蛊
試著書	试著书
碸	砜
嫰	嫩
進帳	进账
夾著書	夹著书
連著錄	连著录
乾县	乾县
橜	橛
枕著作	枕著作
本份	本分
喫	吃
喬	乔
橈	桡
縱著	纵着
對帳	对账
瞪著錄	瞪著录
橢	椭
薛丁格	薛定谔
綹	绺
雷諾瓦	雷诺阿
橫	横
數著稱	数著称
厠	厕
厤	历
鏢	镖
綽	绰
騙著作	骗著作
樂著	乐着
伴著稱	伴著称
厰	厂
網	网
厲	厉
於夫羅	於夫罗
厴	厣
荊	荆
繞著	绕着
綰	绾
著祂	着祂
鴉	鸦
著氣	着气
據著稱	据著称
荳	豆
受著	受着
瞧著錄	瞧著录
䥱	䥾
厙	厍
用著名	用著名
啸吒	啸咤
鼃	蛙
乾位	乾位
外部連結	外部链接
站著	站着
咼	呙
斥著	斥着
碁聖	碁圣
薰陶	熏陶
著火	着火
沖著《	冲著《
尋著者	寻著者
巴塞隆拿	巴塞罗那
沖著。	冲著。
想著者	想著者
獲著述	获著述
藏著書	藏著书
石碁鎮	石碁镇
吹著書	吹著书
猜著錄	猜著录
涼著名	凉著名
演著錄	演著录
著我	着我
記著	记着
帳冊	账册
鼉	鼍
咊	和
緄	绲
緇	缁
備著作	备著作
燒著作	烧著作
緍	𦈏
骾	鲠
於潜县	於潜县
緋	绯
緊	紧
緔	绱
緗	缃
䌰	𦈙
緑	绿
緐	繁
諫	谏
緒	绪
緝	缉
緜	绵
緞	缎
緙	缂
藏著稱	藏著称
𡚁	弊
線	线
緥	褓
配著書	配著书
緦	缌
漫著名	漫著名
締	缔
乾红	乾红
䌋	𦈘
緬	缅
於戲	於戏
牽著作	牵著作
緩	缓
編	编
練	练
緷	𦈉
緶	缏
緱	缑
緰	𦈕
乾纲	乾纲
緲	缈
乾纽	乾纽
緹	缇
緸	𦈑
緻	致
鱨	鲿
媍	妇
衊	蔑
水氣	水汽
慣著名	惯著名
味著	味着
晃著述	晃著述
殀	夭
潤著錄	润著录
衆	众
衇	脉
乾軸	乾轴
鸚	鹦
衛	卫
衝	冲
衞	卫
忍著名	忍著名
蔡絛	蔡絛
甜著	甜着
衕	同
16進位制	16进位制
立著有	立著有
乾車	乾车
媯	妫
𩥉	𩧱
冒著	冒着
𩥄	𩨋
𨴗	𨸅
喚	唤
跳著名	跳著名
媼	媪
媽	妈
向著書	向著书
媿	愧
候著書	候著书
夾著	夹着
媰	㛀
𩥑	𩨌
數位電視	数字电视
飄著稱	飘著称
躉	趸
讒	谗
黏著	黏着
過著錄	过著录
窓	窗
逬	迸
綁著錄	绑著录
䘑	脉
戈巴契夫	戈尔巴乔夫
夾著錄	夹著录
獲著書	获著书
殲	歼
磑	硙
窺	窥
窻	窗
窶	窭
追著作	追著作
窵	窎
窰	窑
變著述	变著述
窯	窑
歐巴馬	奥巴马
窪	洼
考著作	考著作
窩	窝
位元組	字节
樢	㭤
乾矢	乾矢
猜著名	猜著名
尋著稱	寻著称
摟著錄	搂著录
靠著錄	靠著录
醯壺	醯壶
順著稱	顺著称
氾濫	泛滥
望著名	望著名
俔	伣
圍著錄	围著录
臺	台
潤著稱	润著称
醯壶	醯壶
閑著述	闲著述
領著者	领著者
考著錄	考著录
䰟	魂
玀	猡
玁	𤞤
高著名	高著名
玅	妙
鍠	锽
刻著者	刻著者
蜖	蛔
鍥	锲
功能變數名稱	域名
磠	硵
鍩	锘
鍫	锹
磣	碜
剖釐	剖厘
鍮	𨱎
鍰	锾
鍳	鉴
躦	躜
著式	着式
忍著稱	忍著称
鍶	锶
鍺	锗
悠著錄	悠著录
錄影帶	录像带
鍾	锺
醱	酦
鍀	锝
鍃	锪
俁	俣
鍅	钫
保障著述	保障著述
鍇	锴
沉著作	沉著作
輊	轾
鍈	锳
音效卡	声卡
鍊	炼
據著名	据著名
鍔	锷
譩譆	譩譆
鍛	锻
鍚	钖
動著錄	动著录
乾構	乾构
綈	绨
綉	绣
綏	绥
綌	绤
流著名	流著名
轉著者	转著者
背著作	背著作
綆	绠
綇	𦈋
綞	缍
笨豬跳	蹦极跳
綜	综
經	经
借著述	借著述
綑	捆
乾统	乾统
乾络	乾络
綫	线
月陞	月升
綯	绹
綬	绶
維	维
綢	绸
綣	绻
綠	绿
綺	绮
綻	绽
綸	纶
記著稱	记著称
綾	绫
綿	绵
乾维	乾维
變著者	变著者
麗著書	丽著书
綱	纲
顇	悴
綴	缀
綵	彩
乾台	乾台
卡佩雅蒂	卡普里亚蒂
行著述	行著述
殞	殒
殘	残
百慕達	百慕大
堅杜拜	坚杜拜
戴著名	戴著名
臘	腊
殰	㱩
殼	壳
殻	壳
殺	杀
殤	殇
䰾	鲃
殯	殡
殮	殓
殭	僵
殫	殚
載著	载着
燴	烩
額	额
題	题
顏	颜
顎	颚
硃色	朱色
顋	腮
得著書	得著书
顆	颗
顃	𩖖
㠶	帆
二極體	二极管
顙	颡
願	愿
著驚	着惊
顔	颜
蘸著作	蘸著作
顓	颛
㓨	刾
拉著	拉着
顬	颥
顯	显
塞爾維亞與蒙特內哥羅	塞尔维亚和黑山
顫	颤
顥	颢
顧	顾
顦	憔
姓么	姓幺
顢	颟
著趣	着趣
抝	拗
放著称	放著称
看著述	看著述
顴	颧
叫著名	叫著名
顒	颙
顱	颅
顰	颦
顳	颞
忙著書	忙著书
韌體	固件
偷著書	偷著书
衣著述	衣著述
呪	咒
夾著述	夹著述
罋	瓮
著數	着数
滑鼠	鼠标
視著名	视著名
高著	高着
逕啟	径启
呌	叫
甜著者	甜著者
心著者	心著者
錦	锦
錢	钱
錠	锭
遇著作	遇著作
錮	锢
積極份子	积极分子
錫	锡
曾运乾	曾运乾
用著	用着
錶	表
沒	没
努力著錄	努力著录
釐整	厘整
録	录
沖	冲
立著者	立著者
么喝	幺喝
錼	镎
三藩市	旧金山
味著名	味著名
錸	铼
錆	锖
錇	锫
錄	录
錂	𨱋
跳著述	跳著述
蒙著述	蒙著述
錏	铔
光碟機	光驱
錈	锩
開著名	开著名
錕	锟
錒	锕
錐	锥
錟	锬
㢘	廉
鋪著書	铺著书
錛	锛
刻著錄	刻著录
㢝	𢋈
隻言片語	只言片语
礆	碱
知識份子	知识分子
𩤸	𩨅
袟	帙
罸	罚
𩛩	𩠃
流著作	流著作
愛著作	爱著作
𩤲	𩨉
來著錄	来著录
薰心	熏心
響	响
𩤊	𩧩
吳克羣	吴克羣
過著述	过著述
乾棟	乾栋
備著者	备著者
𩤙	𩨆
隔著作	隔著作
婣	姻
畵	画
婦	妇
袵	衽
婭	娅
婬	淫
莢	荚
驏	骣
莧	苋
鷦	鹪
急著錄	急著录
乾花	乾花
低著書	低著书
嚷著者	嚷著者
戴著書	戴著书
卻	却
看著者	看著者
區	区
皁保	皁保
穿著者	穿着者
莊	庄
阳为乾	阳为乾
協	协
雅著称	雅著称
莖	茎
雜訊	噪声
苦著述	苦著述
鋪著名	铺著名
戴著稱	戴著称
晃著者	晃著者
陋著錄	陋著录
牽	牵
韍	韨
飄著書	飘著书
牠	它
軟體生物	软体生物
仰屋著書	仰屋著书
為著述	为著述
牕	窗
牓	榜
紀錄著	纪录着
輙	辄
牐	闸
附著作	附著作
韈	袜
慣著	惯着
穀阳	穀阳
牘	牍
牆	墙
鷴	鹇
忠貞著	忠贞着
牀	床
牎	窗
駕著作	驾著作
牋	笺
鬥著名	斗著名
乾，天也	乾，天也
𤸫	𤶧
說著述	说著述
甦醒	苏醒
韃	鞑
燒著述	烧著述
吳	吴
接著作	接著作
鷿	䴙
宮	宫
魚雷	鱼雷
過著稱	过著称
當著作	当著作
鷽	鸴
訶	诃
獲著名	获著名
蘸著錄	蘸著录
崑腔	昆腔
著撰	着撰
訴	诉
閌	闶
語著	语着
黄润乾	黄润乾
診	诊
持著	持着
附著稱	附著称
跳著書	跳著书
籌	筹
籋	𥬞
關著者	关著者
乾紅	乾红
挑著稱	挑著称
籟	籁
籜	箨
閉著	闭着
籙	箓
促著	促着
𠠎	𠚳
籔	䉤
網際網絡	互联网
乾紐	乾纽
抓著	抓着
騙著者	骗著者
駕著	驾着
電腦程式	计算机程序
發著稱	发著称
籪	簖
籩	笾
順著作	顺著作
潤著述	润著述
鷀	鹚
代表著	代表着
䮝	𩧰
籠	笼
乾道	乾道
困著書	困著书
籲	吁
信著述	信著述
B肝	乙肝
躍著錄	跃著录
伴著者	伴著者
簽帳	签账
視著稱	视著称
畫	画
間	间
畮	亩
畱	留
異	异
殺著作	杀著作
鈅	钥
坐著錄	坐著录
訪	访
聽著書	听著书
燦	灿
畂	亩
關著錄	关著录
畆	亩
盛著書	盛著书
扛著書	扛著书
扛著述	扛著述
心著述	心著述
努力著書	努力著书
快閃記憶體	闪存
牴	抵
鋃	锒
徵狀	症状
畝	亩
頒	颁
頓	顿
預	预
頑	顽
頗	颇
求著者	求著者
穀陽	穀阳
領	领
頟	额
頜	颌
假帳	假账
頂	顶
頃	顷
乾巛	乾巛
頁	页
順	顺
頇	顸
乾州	乾州
頊	顼
託	托
須	须
頎	颀
頏	颃
頌	颂
閡	阂
頲	颋
頰	颊
呂	吕
頷	颔
頴	颕
頻	频
頸	颈
頹	颓
頼	赖
鷚	鹨
訛	讹
拚	拼
頡	颉
頦	颏
空著述	空著述
罵著名	骂著名
衣著称	衣著称
溢著書	溢著书
頭	头
漲	涨
爲	为
住著称	住著称
努力著	努力着
爾	尔
爺	爷
蒐錄	搜录
陈元扞	陈元扞
盛著錄	盛著录
駕著書	驾著书
東協議	东协议
爭	争
閑著作	闲著作
走著名	走著名
戀著者	恋著者
䕳	𦰴
側著	侧着
錡	锜
閶	阊
爛	烂
爄	𤇃
三十六著	三十六着
錯	错
爍	烁
悠著	悠着
喀拉蚩	卡拉奇
荠苧	荠苧
候著稱	候著称
況	况
因著書	因著书
乾象历	乾象历
𢹿	𢬦
㥮	㤘
乾启	乾启
閼	阏
頂著名	顶著名
錨	锚
墨瀋	墨渖
錩	锠
泝	溯
郵	邮
閿	阌
慘	惨
扛著	扛着
乾吉	乾吉
閹	阉
夾著稱	夹著称
郟	郏
背著者	背著者
昂山素姬	昂山素季
昭著	昭著
爭著	争着
睡著	睡着
閻	阎
寮人民民主共和國	老挝人民民主共和国
矇眬	矇眬
獲著稱	获著称
走著述	走著述
餜	馃
迻	移
毆	殴
變著錄	变著录
托巴哥	多巴哥
遍布著	遍布着
蘤	花
倖一郎	倖一郎
見著書	见著书
乾化	乾化
毿	毵
乘著稱	乘著称
蓋著名	盖著名
𢷮	𢫊
餄	饸
數位訊號	数字信号
豎著者	竖著者
綐	䌼
遇著者	遇著者
匯	汇
晉陞	晋升
試著述	试著述
梅赫西迪	梅赛德斯
華	华
制著作	制著作
餓	饿
匲	奁
備著稱	备著称
匱	匮
鏈結	链接
菸	烟
錁	锞
上昇	上升
遇著称	遇著称
下著	下着
隨著書	随著书
金鍊	金链
滿16進位	满16进位
拿著稱	拿著称
蘸著述	蘸著述
䬃	飒
駕	驾
乾崗	乾岗
戩	戬
駒	驹
駑	驽
駐	驻
駟	驷
駝	驼
王餘魚	王馀鱼
駚	𩧫
變著書	变著书
駘	骀
追著述	追著述
亮著名	亮著名
列支敦斯登	列支敦士登
馬利共和國	马里共和国
見著錄	见著录
駁	驳
背著錄	背著录
䱷	䲣
戶	户
矽塵	矽尘
諄	谆
駈	驱
庫德族	库尔德族
駱	骆
疊代	迭代
駿	骏
美著作	美著作
戇	戆
駻	𫘣
戀	恋
耀著書	耀著书
餃	饺
駧	𩧲
戞	戛
駢	骈
駡	骂
乾盛世	乾盛世
著妳	着妳
餁	饪
照著名	照著名
麗著稱	丽著称
餾	馏
唱著書	唱著书
制著	制着
散布著	散布着
𦊱	挂
扛著名	扛著名
賈伯斯	乔布斯
雜著	杂着
幹著	干着
掖著	掖着
碁圣	碁圣
住著述	住著述
錚	铮
留著稱	留著称
情蒐	情搜
為著稱	为著称
跪著書	跪著书
錘	锤
李譔	李譔
錙	锱
緡	缗
乾轴	乾轴
餿	馊
娛	娱
補	补
裝	装
紐	纽
乾车	乾车
揚	扬
殘瀋	残渖
裊	袅
仗著述	仗著述
餱	糇
裏	里
過份	过分
醯酱	醯酱
䬘	𩙮
傯	偬
䬞	𩙧
裠	裙
餭	𫗮
涼著	凉着
侏儸紀	侏罗纪
落著	落着
產	产
産	产
搜尋引擎	搜索引擎
餽	馈
晃著作	晃著作
掃瞄	扫描
彷彿	仿佛
福著名	福著名
乾行	乾行
昇仙	升仙
婁	娄
陳乾生	陈乾生
走著錄	走著录
𡻕	岁
甌	瓯
甎	砖
暗闇	暗闇
輿	舆
甕	瓮
甖	罂
持著述	持著述
部份	部分
守著称	守著称
堅	坚
伏地挺身	俯卧撑
鵬	鹏
照著錄	照著录
勦	剿
乾鹄	乾鹄
急著	急着
寫著稱	写著称
勢	势
據著者	据著者
勻	匀
勸	劝
關著作	关著作
勳	勋
呆著	呆着
乾笃	乾笃
勌	倦
盯著稱	盯著称
勅	敕
馬拉威	马拉维
勁	劲
盧安達	卢旺达
王道乾	王道乾
勝	胜
臋	臀
勛	勋
佈	布
務	务
動	动
壓著名	压著名
狹	狭
信著	信着
著處	着处
學著述	学著述
涼著稱	凉著称
尖峰時間	高峰时间
轉著述	转著述
連著者	连著者
狥	徇
坤乾	坤乾
䫴	𩖗
跪著	跪着
滿著者	满著者
暗著作	暗著作
乾冈	乾冈
盡	尽
耀著錄	耀著录
狀	状
馬爾他	马耳他
蛕	蛔
顯著	显著
溢著名	溢著名
簀	箦
努力著述	努力著述
膠著錄	胶著录
數著名	数著名
鉑	铂
寫著名	写著名
蒐藏	搜藏
李祕	李祕
乾栋	乾栋
簮	簪
薰香	熏香
纏著者	缠著者
簫	箫
潤著名	润著名
乾絡	乾络
簡	简
嚷著書	嚷著书
簣	篑
光著作	光著作
簾	帘
簹	筜
數位照相機	数码照相机
簷	檐
冒著名	冒著名
頂著書	顶著书
黃	黄
駕著述	驾著述
鉞	钺
讎夷	雠夷
欞	棂
欓	𣗋
欒	栾
沈沒	沉没
視著	视着
欖	榄
堂姊	堂姐
笑著名	笑著名
欍	𣐤
漚	沤
欏	椤
認	认
借著作	借著作
掖著錄	掖著录
鉚	铆
銷帳	销账
點	点
鋸	锯
欽	钦
騙著書	骗著书
譭	毁
䲁	鳚
做著稱	做著称
留著名	留著名
側著錄	侧著录
黲	黪
乾宁	乾宁
「	“
」	”
『	‘
』	’
黿	鼋
愛著錄	爱著录
黽	黾
乾宇	乾宇
於賢德	於贤德
痠	酸
伊斯蘭瑪巴德	伊斯兰堡
壓著錄	压著录
拖著作	拖著作
領著錄	领著录
臨著錄	临著录
行人路权	行人路权
痲	痳
耀著者	耀著者
抬著名	抬著名
低著者	低著者
鬥著作	斗著作
陋著者	陋著者
饃	馍
乾皋	乾皋
槍枝	枪支
鳥	鸟
鍋	锅
鉋	铇
著腳	着脚
隔著述	隔著述
痙	痉
福著述	福著述
么九	幺九
譜	谱
對著者	对著者
盛著述	盛著述
鉶	铏
喝著名	喝著名
慘澹	惨淡
識	识
馴	驯
石碁	石碁
馱	驮
馳	驰
繞著書	绕著书
扞	捍
著她	着她
偷著述	偷著述
因著录	因著录
豎著述	竖著述
努力著者	努力著者
抱著作	抱著作
馬	马
馭	驭
馮	冯
鉿	铪
欠帳	欠账
竹昇	竹升
氂	牦
氌	氇
氈	毡
鉸	铰
卽	即
乾命	乾命
讎定	雠定
後姓	後姓
釳	𨰿
領著稱	领著称
鉺	铒
戀著錄	恋著录
邊	边
猜著者	猜著者
拎著稱	拎著称
邏	逻
刻著稱	刻著称
還	还
接著稱	接著称
乾马	乾马
氷	冰
鉦	钲
氳	氲
踏著作	踏著作
邐	逦
㤙	恩
著錄規則	著录规则
含著稱	含著称
姙	妊
彰明較著	彰明较著
譊	𫍢
騎著書	骑著书
嶄	崭
釺	钎
複	复
見著	见著
姉	姊
漊	溇
拿著者	拿著者
望著錄	望著录
靠著者	靠著者
辛康納利	肖恩·康纳利
褌	裈
譆	嘻
代表著稱	代表著称
褳	裢
褲	裤
釦	扣
投機份子	投机分子
褻	亵
褸	褛
打著作	打著作
行動網路	移动网络
嚷著錄	嚷著录
無言不讎	无言不雠
鍊子	链子
釣	钓
褭	袅
苦著者	苦著者
德勒斯登	德累斯顿
姦	奸
歟	欤
歛	敛
著地	着地
歐	欧
鋦	锔
歎	叹
光著称	光著称
麗	丽
戧	戗
侷促	局促
當著	当着
原子筆	圆珠笔
網站連結	网站链接
歿	殁
慇勤	殷勤
達著稱	达著称
歸	归
敞著者	敞著者
麨	𪎊
歷	历
歴	历
麫	面
歲	岁
麯	曲
氧份	氧分
麲	𪎉
麳	𪎌
克卜勒	开普勒
麵	面
哭著作	哭著作
水份	水分
祖雲達斯	尤文图斯
逼著稱	逼著称
歡	欢
嗅著	嗅着
聯	联
逕自	径自
見著述	见著述
釔	钇
効	效
聾	聋
因著稱	因著称
聰	聪
據著述	据著述
醜著名	丑著名
聳	耸
聵	聩
聶	聂
辦著稱	办著称
劌	刿
劍	剑
叱吒	叱咤
照著者	照著者
劉	刘
劊	刽
瞧著名	瞧著名
本著書	本著书
踩著	踩着
劇	剧
睡著書	睡著书
釀著者	酿著者
挑著作	挑著作
釀著	酿着
淥	渌
劑	剂
劒	剑
主機板	主板
飄著	飘着
踐	践
乾为阳	乾为阳
挑著錄	挑著录
乘著述	乘著述
保障著作	保障著作
甜著書	甜著书
住著者	住著者
，陞	，升
踰	逾
數據機	调制解调器
響著	响着
嶽	岳
淺	浅
糝	糁
糞	粪
護著稱	护著称
空著作	空著作
𡞵	㛟
跪著錄	跪著录
印著書	印著书
萴	荝
䈰	筲
鉸鍊	铰链
經濟帳	经济账
糲	粝
糴	籴
糶	粜
糹	纟
配合著	配合着
糾	纠
低著名	低著名
廬	庐
糧	粮
䱽	䲝
乾綱	乾纲
寮語	老挝语
鋮	铖
趴著書	趴著书
襖	袄
妝	妆
披著	披着
襝	裣
枕著	枕着
襀	𫌀
襃	褒
襍	杂
襏	袯
襉	裥
爨翫	爨翫
響著者	响著者
襴	襕
襲	袭
鶯	莺
妳	你
恆	恒
妷	侄
襤	褴
妬	妒
廡	庑
襬	䙓
襯	衬
襪	袜
樿	椫
戹	厄
擬	拟
鬥著錄	斗著录
幺麽	幺麽
䱬	𩾊
疿	痱
遺著	遗著
仗著作	仗著作
項鍊	项链
戴卓爾	撒切尔
廚	厨
爭著作	争著作
西元9	公元9
壓著者	压著者
疎	疏
向著稱	向著称
西元1	公元1
西元2	公元2
西元3	公元3
西元4	公元4
西元5	公元5
西元6	公元6
西元7	公元7
疘	肛
解像度	分辨率
飛彈	导弹
擴	扩
毛里裘斯	毛里求斯
擷	撷
曠	旷
拼著者	拼著者
呆帳	呆账
對著書	对著书
犧	牺
廐	厩
犢	犊
撼著錄	撼著录
燒著	烧着
乾上乾下	乾上乾下
犖	荦
於乎	於乎
渴著作	渴著作
刧	劫
想著称	想著称
照著稱	照著称
鸕	鸬
働	动
寮國	老挝
遯	遁
適	适
覔	觅
醜著稱	丑著称
遠	远
麻薩諸塞	马萨诸塞
遼	辽
汙	污
選	选
遺	遗
乾首	乾首
含著者	含著者
急著書	急著书
遲	迟
滿十進位	满十进位
乾馬	乾马
過	过
遉	侦
運	运
遊	游
隨著稱	随著称
趴著名	趴著名
決	决
遜	逊
遞	递
遙	遥
違	违
達	达
嚶	嘤
昂著作	昂著作
著迷	着迷
存著	存着
著述	著述
拿著名	拿著名
挨著錄	挨著录
IP位址	IP地址
膞	䏝
候著者	候著者
粃	秕
夾著作	夹著作
獨鍾	独钟
嚳	喾
膠著書	胶著书
䉲	𥮜
鶡	鹖
猜著書	猜着书
粵	粤
有著書	有著书
粧	妆
跪著者	跪著者
高著錄	高著录
䉙	𥬀
著然	着然
席哈克	希拉克
檔	档
擕	携
撣	掸
撡	操
用著錄	用著录
撦	扯
踁	胫
撫	抚
撳	揿
賒帳	赊账
鶪	䴗
嚥	咽
撻	挞
英呎	英尺
晃著名	晃著名
撿	捡
撾	挝
矇矓	矇眬
檭	𣘴
領著述	领著述
撈	捞
撏	挦
撓	挠
樂著名	乐著名
撐	撑
拖著者	拖著者
光著述	光著述
鹽	盐
鹼	碱
西臺文	赫梯文
鹹	咸
據著錄	据著录
鹻	碱
鹺	鹾
映著書	映著书
饝	馍
饜	餍
演著述	演著述
饞	馋
饑	饥
䭀	𩠇
掽	碰
連著名	连著名
𩜵	𩠊
饗	飨
𢶫	𢫞
饉	馑
饈	馐
饋	馈
饊	馓
饍	膳
學著錄	学著录
採	采
扞格	扞格
饁	馌
打著錄	打著录
饅	馒
掗	挜
乾穹	乾穹
鶿	鹚
陞為	升为
遇著	遇着
順著述	顺著述
掛	挂
爭著者	争著者
寫著	写着
掆	㧏
衣著稱	衣著称
普利茲	普利策
醯鸡	醯鸡
壓著稱	压著称
饢	馕
𨳕	𨸀
𨳑	𨸁
機械人	机器人
占著者	占著者
蹌	跄
蹏	蹄
鶇	鸫
蹔	暂
蹕	跸
忌廉	奶油
吚	咿
著摸	着摸
蹟	迹
蹠	跖
颳著	刮着
膠著名	胶著名
蹤	踪
蹧	糟
沿著書	沿著书
柳诒徵	柳诒徵
別	别
有著稱	有著称
蹵	蹴
猜著稱	猜著称
福著者	福著者
蹻	𫏋
進	进
週	周
涇	泾
渙	涣
站著作	站著作
連	连
麗著者	丽著者
紿	绐
逥	回
曠若發矇	旷若发矇
拖著錄	拖著录
逩	奔
總帳	总账
㦎	𢛯
跪著名	跪著名
這	这
渴著述	渴著述
醯雞	醯鸡
壓著	压着
縭	缡
千里達托貝哥	特立尼达和托巴哥
忙著名	忙著名
覘	觇
𤱈	亩
壓著書	压著书
覓	觅
心著錄	心著录
奐	奂
視	视
覈	核
開著書	开著书
覊	羁
跟著書	跟著书
拿著作	拿著作
覎	觃
𩸦	𩾆
覇	霸
智慧卡	智能卡
奼	姹
膠著述	胶著述
覺	觉
學著作	学著作
覼	𫌨
覿	觌
茅利塔尼亞	毛里塔尼亚
鬥著述	斗著述
覲	觐
縶	絷
覷	觑
拖著述	拖著述
覩	睹
奬	奖
奮	奋
奩	奁
覬	觊
覯	觏
奪	夺
覡	觋
奧	奥
銀鍊	银链
福著作	福著作
𩸃	𩾅
覦	觎
關著述	关著述
載著名	载著名
剳	札
創	创
剴	剀
剷	铲
剹	戮
鵝	鹅
肧	胚
著績	着绩
剾	𠛅
成份股	成份股
漫著書	漫著书
瓜地馬拉	危地马拉
剮	剐
肎	肯
剗	刬
鵜	鹈
剙	创
剛	刚
剝	剥
勞	劳
急著名	急著名
黶	黡
剄	刭
則	则
剉	锉
剋	克
肐	胳
剏	创
剎	刹
籃	篮
轉著作	转著作
魢	鱾
𪋿	𪎍
待著名	待著名
魥	𩽹
䥇	䦂
易·乾	易·乾
銣	铷
趴著述	趴著述
皮雅斯·布士南	皮尔斯·布鲁斯南
显著	显著
壙	圹
䥩	𨱖
達著錄	达著录
追著稱	追著称
憶	忆
籛	篯
䴴	𪎋
䥥	镰
梵谷	梵高
躂	跶
躍	跃
縈	萦
滿八進位	满八进位
躎	䟢
氆氌	氆氌
躋	跻
逕到	径到
躕	蹰
留著者	留著者
躑	踯
躓	踬
躒	跞
拼著稱	拼著称
愛滋	艾滋
鬥著稱	斗著称
躘	𨀁
芮氏地震規模	里氏地震规模
躚	跹
躥	蹿
皺著者	皱著者
躡	蹑
應著錄	应著录
曖	暧
躭	耽
躪	躏
先名後姓	先名后姓
單鏡反光機	单反相机
躳	躬
定著述	定著述
籐	藤
鵓	鹁
漫著述	漫著述
么半	幺半
䊷	䌶
籮	箩
撞球	台球
罈	坛
罎	坛
罌	罂
份外	分外
沿著	沿着
䊭	𥺅
乾潭	乾潭
迦納	加纳
魺	鲄
下著有	下著有
罰	罚
罷	罢
罵	骂
流露著	流露着
䊀	糊
戀著述	恋著述
瑯	琅
曉	晓
滿十六進位	满十六进位
叫著錄	叫著录
手鍊	手链
瑪	玛
瑩	莹
坐著名	坐著名
㠀	岛
瑤	瑶
瑣	琐
乾灵	乾灵
散佈著	散布着
候著作	候著作
乾男	乾男
瑲	玱
舊帳	旧账
瑋	玮
攷	考
瑇	玳
釀著名	酿著名
執行長，	首席执行官，
側著者	侧著者
崑劇	昆剧
庇護著	庇护着
身著名	身著名
瑒	玚
塗著	涂着
餞	饯
死帳	死账
揷	插
餚	肴
餛	馄
餘	馀
餖	饾
餗	𫗧
餔	𫗦
餕	馂
餒	馁
揹	背
餑	饽
餎	饹
餏	饻
餌	饵
養	养
餈	糍
餉	饷
揮	挥
餅	饼
蒲美蓬	普密蓬
揫	揪
配合著名	配合著名
照著書	照著书
餼	饩
豎著作	竖著作
餺	馎
揑	捏
餸	𩠌
餹	糖
餶	馉
餷	馇
餵	喂
餳	饧
高著書	高著书
換	换
罵著書	骂著书
揀	拣
館	馆
餦	𫗠
皺著名	皱著名
餡	馅
䦟	䦷
䦘	𨸄
䦛	䦶
畢	毕
𪈼	𪉓
為著錄	为著录
攩	挡
𩛆	𩠂
帳外	账外
資訊理論	信息论
尋著書	寻著书
畧	略
連著述	连著述
言幾析理	言幾析理
罵著稱	骂著称
乾符	乾符
攪	搅
得著者	得著者
掖著者	掖著者
趲	趱
䦳	𨷿
攬	揽
舩	船
當著名	当著名
管著述	管著述
吴克羣	吴克羣
忙著稱	忙著称
低著述	低著述
待著述	待著述
雖	虽
釷	钍
照著	照着
釵	钗
附著書	附著书
蓋著	盖着
候著名	候著名
託麻	讬麻
坚杜拜	坚杜拜
釹	钕
釧	钏
笑著	笑着
點著者	点著者
釤	钐
向著述	向著述
淚	泪
淛	浙
釬	焊
釩	钒
牽著書	牵著书
釗	钊
釕	钌
寫著錄	写著录
釓	钆
釒	钅
淪	沦
幫著	帮着
針	针
攖	撄
落著者	落著者
釙	钋
釘	钉
甘迺迪	肯尼迪
攙	搀
釅	酽
釃	酾
釁	衅
釀	酿
悠著述	悠著述
淵	渊
淶	涞
釋	释
保障著称	保障著称
當	当
擠	挤
鸋	𫛢
擣	𢭏
鸎	莺
鸏	鹲
鸌	鹱
擧	举
鸂	㶉
攝	摄
分布著	分布着
鸇	鹯
擯	摈
擰	拧
鸛	鹳
鸘	鹴
米高·奧雲	迈克尔·欧文
鸞	鸾
麗著作	丽著作
鸝	鹂
英吋	英寸
擺	摆
擻	擞
擼	撸
擽	㧰
擾	扰
浮著	浮着
擁	拥
擄	掳
擇	择
嚷著作	嚷著作
擋	挡
橋	桥
蝦	虾
擓	㧟
擔	担
海浬	海里
據	据
鶖	鹙
因著錄	因著录
胷	胸
皺著錄	皱著录
刼	劫
博和託	博和讬
點著錄	点著录
刦	劫
與著作	与著作
朝著	朝着
據著作	据著作
鶗	𫛸
刪	删
前波莫瑞	前波美拉尼亚
雅著稱	雅著称
挑著	挑着
覆著	覆着
點陣圖	位图
乾西	乾西
難	难
離	离
駕著錄	驾著录
挾	挟
挱	挲
冒著述	冒著述
挵	弄
繞著者	绕著者
挩	捝
雲	云
跼限	局限
苧烯	苧烯
電	电
閧	哄
拿破崙	拿破仑
浮著作	浮著作
矚	瞩
軑	轪
到帳	到账
雋	隽
唱著	唱着
遇著錄	遇著录
寫著作	写著作
閑著名	闲著名
繻	𦈡
赫魯雪夫	赫鲁晓夫
雙	双
碙	𥐻
帶著作	带著作
雜	杂
車	车
軋	轧
乾音	乾音
軉	𨉗
軏	𫐄
軌	轨
軍	军
麗著名	丽著名
軀	躯
贐	赆
提昇	提升
軛	轭
大麴	大曲
軟	软
鋪著	铺着
留著述	留著述
溫納圖	瓦努阿图
涼著錄	凉著录
軗	𨐅
軔	轫
軫	轸
軨	𫐉
伊利諾	伊利诺伊
想著書	想著书
鈋	𨱂
穿著述	穿著述
逕取	径取
笑著者	笑著者
軺	轺
軻	轲
軸	轴
軹	轵
軾	轼
夾著名	夹著名
軲	轱
𨵩	𨸆
捆著稱	捆著称
義大利	意大利
夢	梦
走著書	走著书
夠	够
觝	抵
蒐購	搜购
行動電話	移动电话
忙著述	忙著述
聞著	闻着
披著者	披著者
望著	望着
𩿪	𪉄
軤	轷
原始碼	源代码
靠著述	靠著述
驚	惊
夾	夹
觀	观
鬧著	闹着
味著者	味著者
觸	触
觶	觯
苦著書	苦著书
觴	觞
瞧著述	瞧著述
吶	呐
擺著述	摆著述
冒著稱	冒著称
踫	碰
驀	蓦
鈺	钰
鋪著述	铺著述
軼	轶
吹著稱	吹著称
驍	骁
琿	珲
柳詒徵	柳诒徵
琺	珐
鈾	铀
琱	雕
傳著稱	传著称
試著作	试著作
乘著称	乘著称
打著者	打著者
金夏沙	金沙萨
落著書	落著书
千里達	特立尼达
䙡	䙌
六進位	六进制
琖	盏
踩著書	踩著书
行人路	人行道
落著稱	落著称
凱	凯
項	项
塞維亞	塞维利亚
脹	胀
梳著者	梳著者
慇懃	殷勤
脥	𣍰
脣	唇
鈴	铃
凢	凡
脫	脱
掙著	挣着
脗	吻
白瀋	白渖
凙	𪞝
凜	凛
乾一组	乾一组
夥	伙
脛	胫
涼著作	凉著作
哭著書	哭著书
脇	胁
脅	胁
凈	净
脃	脆
凍	冻
掙著名	挣著名
鈮	铌
摟著	搂着
脈	脉
本本份份	本本分分
開帳	开账
𢣭	𢘞
𩚛	𩟿
斥著錄	斥著录
𥢢	䅪
乾策	乾策
流著錄	流著录
躺著	躺着
殺著名	杀著名
轉帳	转账
肘手鍊足	肘手链足
𩚥	𩠀
為著名	为著名
皺著稱	皱著称
紮著	扎着
藉由	借由
䋿	𦈓
踏著者	踏著者
䋻	䌾
䋹	䌿
穤	糯
逼著名	逼著名
頽	颓
含著	含着
陞了	升了
姸	妍
演著作	演著作
缽	钵
已開發國家	发达国家
領著作	领著作
䋚	䌻
䋙	䌺
殨	㱮
搥	捶
搤	扼
頤	颐
獼	猕
陳元扞	陈元扞
搯	掏
搨	拓
搵	揾
以微知著	以微知著
搶	抢
鯢	鲵
乾鉴	乾鉴
搾	榨
搇	揿
搆	构
西洋棋	国际象棋
讐	雠
損	损
頮	颒
兒宽	兒宽
搉	榷
秈	籼
搗	捣
搖	摇
揮著述	挥著述
穀梁	穀梁
抬著錄	抬著录
捆著名	捆著名
撼著者	撼著者
裝著錄	装著录
穿著書	穿著书
著聞	着闻
魏徵	魏徵
讚	赞
瓕	𤦀
瓔	璎
瓚	瓒
優先順序	优先级
存著名	存著名
紮著書	扎著书
䪘	𩏿
獲著	获着
循著述	循著述
著聲	着声
瓏	珑
當著稱	当著称
隣	邻
膠著稱	胶著称
南韓	韩国
鋙	铻
隨	随
險	险
捲	卷
緯	纬
提著名	提著名
躍著	跃着
隱	隐
落著作	落著作
帳目	账目
捫	扪
捨	舍
學著稱	学著称
隸	隶
隻	只
應著	应着
夘	卯
隂	阴
隄	堤
顛	颠
隉	陧
隊	队
響著錄	响著录
階	阶
𡾱	㟜
隕	陨
隖	坞
捄	救
際	际
留著錄	留著录
逆著名	逆著名
攤	摊
計畫	计划
辤	辞
醼	宴
黏著作	黏著作
庫	库
醻	酬
殺著書	杀著书
鍾靈	钟灵
拼著	拼着
醣	糖
獵	猎
醯	酰
醫	医
醕	醇
乾仪	乾仪
困著稱	困著称
醜	丑
醞	酝
覆蓋著	覆盖着
乾啟	乾启
曡	叠
映著名	映著名
索馬利蘭	索马里兰
雷射	激光
療效顯著	疗效显著
懷著名	怀著名
醃	腌
洩	泄
昇華	升华
喝著述	喝著述
存在著	存在着
蘢	茏
著槁	着藁
壢	坜
壠	垅
壯	壮
殺著稱	杀著称
壩	坝
智財權	知识产权
湊合著	凑合着
爗	烨
孼	孽
蘺	蓠
壽	寿
著者	著者
壻	婿
壺	壶
壇	坛
蘀	萚
演著	演着
顯著性	显著性
五箇山	五箇山
詡	诩
壎	埙
壋	垱
壈	𡒄
蘓	苏
柏林圍牆	柏林墙
蘐	萱
壓	压
偷著	偷着
來著述	来著述
壞	坏
待著者	待著者
壜	坛
蘞	蔹
逼著述	逼著述
壘	垒
龍	龙
龎	厐
控制項	控件
吹著者	吹著者
摯	挚
偷著作	偷著作
巒	峦
鹼菜	硷菜
摺	折
摻	掺
立著稱	立著称
枕著名	枕著名
帶著	带着
龔	龚
伴著名	伴著名
史達林	斯大林
摶	抟
龑	䶮
著鞭	着鞭
么二三	幺二三
龯	𨱆
摃	扛
陪著名	陪著名
摟	搂
摜	掼
文徵明	文徵明
𧩙	䜥
纏著名	缠著名
持著稱	持著称
屓	屃
謬	谬
閑著稱	闲著称
冺	泯
慼	戚
逆著錄	逆著录
矽谷	硅谷
腸	肠
踏著述	踏著述
嚷著述	嚷著述
腦	脑
戀著作	恋著作
乾興	乾兴
挨著者	挨著者
與著述	与著述
含著書	含著书
腪	𣍯
腫	肿
𤒎	𤊀
發著	发着
冐	冒
冑	胄
詗	诇
紮著述	扎著述
困著	困着
亮著書	亮著书
鋟	锓
腁	胼
腎	肾
待著作	待著作
著末	着末
流水帳	流水账
載	载
輈	辀
輇	辁
慣著者	惯著者
輄	𨐈
較	较
孟德爾遜	门德尔松
輟	辍
輞	辋
輝	辉
輜	辎
輛	辆
𥿊	𦈈
天份	天分
輗	𫐐
輕	轻
輔	辅
輓	挽
輒	辄
𨶀	𨸉
輯	辑
著有	著有
賡	赓
占士邦	詹姆斯·邦德
輪	轮
輩	辈
輦	辇
輥	辊
𨶲	𨸋
碧咸	贝克汉姆
向著錄	向著录
輾	辗
輼	辒
輻	辐
輸	输
痺	痹
趕著作	赶著作
洶	汹
醜著作	丑著作
巔	巅
守著述	守著述
急著稱	急著称
雅爾達	雅尔塔
醉瀋	醉渖
黏著者	黏著者
畫著	画着
隨著作	随著作
摟著名	搂著名
翄	翅
譯著	译著
聽著	听着
潔	洁
翽	翙
乾精	乾精
侷限	局限
翹	翘
著白	着白
復甦	复苏
敞著	敞着
翬	翚
硬體	硬件
詎	讵
翫	玩
刮著	刮着
鋪著作	铺著作
點著作	点著作
樂著稱	乐著称
墮	堕
滿二進位	满二进位
虯	虬
墰	坛
墳	坟
辦著書	办著书
墻	墙
乾鑒	乾鉴
虆	蔂
屨	屦
耀著作	耀著作
墊	垫
晃著稱	晃著称
墖	塔
處	处
墜	坠
報帳	报账
規畫	规划
惏慄	惏慄
虜	虏
匭	匦
號	号
工具機	机床
達著名	达著名
𤺥	瘩
環	环
份內	分内
盯著書	盯着书
歷陞	历升
建帳	建账
璸	瑸
璦	瑷
璢	瑠
璣	玑
璡	琎
靠著作	靠著作
璯	㻅
當著者	当著者
凴	凭
著肉	着肉
渦	涡
穿著	穿着
捆著錄	捆著录
𥽖	𥺇
皐	皋
喝著者	喝著者
渢	沨
達·文西	达·芬奇
載著錄	载著录
馬斯垂克	马斯特里赫特
憫	悯
昂著書	昂著书
䠶	射
䭃	𩠈
螢光棒	荧光棒
麗著	丽着
榦	干
𩙈	𩙰
㜄	㚯
空著名	空著名
著要	着要
碁所	碁所
下著录	下著录
映著述	映著述
䠀	蹚
安地卡及巴布達	安提瓜和巴布达
多明尼加	多米尼加
柯林頓	克林顿
陞官	升官
𩵩	𩽺
顯著效果	显著效果
鍬	锹
連著作	连著作
應著述	应著述
鐨	镄
軟體	软件
浹	浃
酈	郦
行著者	行著者
拖著	拖着
乾風	乾风
酇	酂
羢	绒
雜著名	杂著名
黃潤乾	黄润乾
羥	羟
羨	羡
義	义
塞普勒斯	塞浦路斯
硃紅	朱红
羶	膻
沖著，	冲著，
留著	留着
𡑭	𡋗
沖著（	冲著（
獱	㺍
拚命	拚命
醜著錄	丑著录
羆	罴
滿著作	满著作
羅	罗
羋	芈
陳公乾生	陈公乾生
荷姆茲	霍尔木兹
金氏世界紀錄	吉尼斯世界纪录
行著書	行著书
執行長。	首席执行官。
羗	羌
正體中文	繁体中文
執行長、	首席执行官、
為著	为着
摟著述	搂著述
斬	斩
齕	龁
齔	龀
齗	龂
齙	龅
齜	龇
齟	龃
於	于
史特勞斯	斯特劳斯
斷	断
蜋	螂
閑著者	闲著者
梳著錄	梳著录
齏	齑
齎	赍
齲	龋
戰著述	战著述
齷	龌
齶	腭
斆	敩
斅	𢽾
斃	毙
斂	敛
齡	龄
齠	龆
齣	出
裌	袷
齦	龈
齩	咬
乾錄	乾录
斕	斓
抓著述	抓著述
齬	龉
䧢	𨸟
唱著作	唱著作
陣	阵
冒著作	冒著作
乾龍	乾龙
拎著者	拎著者
夢著者	梦著者
乾构	乾构
乾德	乾德
陳	陈
行著錄	行著录
陽	阳
陿	狭
獄	狱
心著書	心著书
陻	堙
乾龙	乾龙
學著書	学著书
易經乾	易经乾
鍵	键
乾律	乾律
陗	峭
帶著述	带著述
乾枢	乾枢
陝	陕
陜	陕
達著書	达著书
陘	陉
賷	赍
蔘	参
昂著名	昂著名
轎	轿
轉	转
陪著稱	陪著称
轄	辖
轅	辕
轆	辘
轀	辒
放著作	放著作
朝著作	朝著作
轟	轰
留著作	留著作
轔	辚
做著	做着
斥著書	斥著书
聖馬利諾	圣马力诺
轤	轳
高著作	高著作
𨷲	𨸎
身著述	身著述
低著称	低著称
於乙宇同	於乙宇同
䭾	驮
𩭙	𩬣
䭿	𩧭
藉助	借助
乾图	乾图
鄺	邝
溝	沟
躍著者	跃著者
躝	𨅬
鄴	邺
六進位制	六进位制
鄲	郸
準	准
鄰	邻
A型肝炎	甲型肝炎
鄭	郑
鱷	鳄
鐶	镮
點著稱	点著称
乾风	乾风
梳著名	梳著名
考著者	考著者
千里達及托巴哥	特立尼达和多巴哥
鄔	邬
字乾生	字乾生
鄒	邹
豎著名	竖著名
瞧著稱	瞧著称
毧	绒
㺏	𤠋
鄉	乡
鄆	郓
躺著作	躺著作
著勁	着劲
冒著者	冒著者
團	团
顯著成績	显著成绩
敺	驱
繢	缋
塢	坞
狗隻	犬只
塹	堑
毬	球
逼著書	逼著书
數	数
昇汞	升汞
塲	场
塵	尘
紮著稱	扎著称
著業	着业
一份子	一分子
羅浮宮	卢浮宫
塏	垲
惏悷	惏悷
心著名	心著名
塚	冢
求著書	求著书
塟	葬
乾維	乾维
著極	着极
塒	埘
裝著者	装著者
蚘	蛔
塗	涂
攆	撵
膽	胆
膿	脓
膾	脍
祕宜	祕宜
占著作	占著作
候覆	候复
黏著述	黏著述
膩	腻
著邊	着边
困著述	困著述
護著名	护著名
膠	胶
內	内
瞞著者	瞒著者
公升	升
著惱	着恼
𨫒	𨱐
膚	肤
瞪著者	瞪著者
膓	肠
開著稱	开著称
膕	腘
兒	儿
兌	兑
兎	兔
膃	腽
𩘝	𩙭
忙著者	忙著者
加彭	加蓬
側著述	侧著述
敗	败
太空飛行員	宇航员
𪇳	𪉕
𩘀	𩙩
耡	锄
𩘹	𩙨
伴著	伴着
𩘺	𩙬
乾篤	乾笃
數位相機	数码相机
困著錄	困著录
光著	光着
看著書	看着书
記帳	记账
演著稱	演著称
喝著作	喝著作
味著錄	味著录
接著	接着
𣯴	𣭤
接著名	接著名
匳	奁
偷著錄	偷著录
拉著錄	拉著录
流動電話	移动电话
漫著錄	漫著录
辳	农
農	农
獨立國家國協	独立国家联合体
𨈌	𨄄
可攜式	便携式
尚比亞	赞比亚
辠	罪
耀著	耀着
掙著書	挣著书
緣份	缘分
辦	办
敂	叩
辭	辞
塑膠袋	塑料袋
辯	辩
辮	辫
繦	襁
。陞	。升
繡	绣
繯	缳
繮	缰
繭	茧
沙烏地阿拉伯	沙特阿拉伯
逕行	径行
繩	绳
學著名	学著名
繳	缴
繰	缲
繿	䍀
繾	缱
繽	缤
繼	继
圍著述	围著述
繹	绎
繸	䍁
台帳	台账
繆	缪
么氏	幺氏
密执安	密歇根
繃	绷
著相	着相
紐西蘭	新西兰
連著	连着
繖	伞
繕	缮
織	织
繓	𦈛
繒	缯
說著稱	说著称
繟	𦈎
繞	绕
繚	缭
跑著作	跑著作
幫著書	帮著书
溢著述	溢著述
䲘	鳤
挨著名	挨著名
𥼽	𥹥
睪	睾
絀	绌
味著稱	味著称
睠	眷
睞	睐
睜	睁
矽钢	矽钢
鍊表	链表
西元前	公元前
睏	困
睍	𪾢
唱著稱	唱著称
乾，健也	乾，健也
纏著稱	缠著称
布隆泉	布隆方丹
潛	潜
乾忠	乾忠
阨	厄
叫著述	叫著述
著實	着实
阬	坑
慣著作	惯著作
潙	沩
A肝	甲肝
威爾斯	威尔士
鯷	鳀
帳款	账款
䲖	𩾂
C肝	丙肝
蘭質薰心	兰质薰心
乾東	乾东
渴著錄	渴著录
潕	𣲘
因著述	因著述
載著述	载著述
纏著述	缠著述
敞著述	敞著述
裡	里
大姊姊	大姐姐
张法乾	张法乾
趕著述	赶著述
儂	侬
䢨	𨑹
儀	仪
絕	绝
抬著作	抬著作
𩟐	𩠅
儈	侩
儉	俭
戯	戏
代表著書	代表著书
絛	绦
儐	傧
駔	驵
乾天也	乾天也
儔	俦
儕	侪
儘	尽
剋架	剋架
償	偿
空中巴士	空中客车
儣	𠆲
優	优
絞	绞
試著名	试著名
鍊條	链条
儷	俪
𣿉	𣶫
儺	傩
儻	傥
帛琉	帕劳
𪔵	𪔭
𪄆	𪉔
禰	祢
儼	俨
𨧜	䦁
背著稱	背著称
滙	汇
滛	淫
展著作	展著作
絡	络
記憶體	内存
賉	恤
滌	涤
駙	驸
滎	荥
應著作	应著作
滅	灭
與著名	与著名
滸	浒
㽞	留
滻	浐
幾內亞比索	几内亚比绍
著力	着力
滿	满
滲	渗
掙著述	挣著述
備著名	备著名
罩著	罩着
滬	沪
鍍	镀
滯	滞
駃	𫘝
資料庫	数据库
活著書	活著书
鼕	咚
噠	哒
旤	祸
隨著述	随著述
裝著作	装著作
旣	既
飄著錄	飘著录
鼇	鳌
旾	春
旹	时
駎	𩧨
鼈	鳖
槕	桌
皺著書	皱著书
鼴	鼹
戱	戯
玻里尼西亞	波利尼西亚
統	统
旂	旗
戰	战
下著作	下著作
不著稱	不著称
榪	杩
帳房	账房
睡著述	睡著述
戲	戏
帳戶	账户
標誌著	标志着
東協會	东协会
戰著	战着
葉門	也门
代表著者	代表著者
頂著	顶着
慣著述	惯著述
臯	皋
滿六進位	满六进位
臨	临
臥	卧
臢	臜
臠	脔
臟	脏
臝	裸
臚	胪
抬著	抬着
臙	胭
臗	𣎑
臕	膘
楓	枫
臏	膑
臍	脐
語著名	语著名
臈	腊
臉	脸
摟著者	搂著者
韮	韭
㿜	瘪
韤	袜
有著作	有著作
蓋著作	盖著作
韻	韵
駸	骎
著它	着它
韌	韧
韋	韦
韉	鞯
與著錄	与著录
韆	千
美著者	美著者
因著者	因著者
韁	缰
刻著書	刻著书
韞	韫
韜	韬
韙	韪
聖露西亞	圣卢西亚
禎	祯
著定	着定
韓	韩
譾	谫
披著述	披著述
著書	著书
定著名	定著名
備著錄	备著录
朝著述	朝著述
駭	骇
簽著	签着
迴	回
發著名	发著名
響著名	响著名
甜著錄	甜著录
駩	𩧴
貽	贻
摟著作	搂著作
保鑣	保镖
備著書	备著书
堯	尧
表姊	表姐
畫著者	画著者
穀	谷
蛺	蛱
蛻	蜕
樂著書	乐著书
駛	驶
吹著名	吹著名
場	场
跑著	跑着
報	报
過著者	过著者
逆著者	逆著者
堊	垩
帕邁拉環礁	巴尔米拉环礁
乾衡	乾衡
沿著錄	沿著录
不著	不着
堝	埚
鵠	鹄
賕	赇
刻著名	刻著名
乾乾淨淨	干干净净
啓	启
眾	众
重覆	重复
耀著述	耀著述
滿著名	满著名
眡	视
伏著	伏着
眥	眦
逕寄	径寄
爛帳	烂账
眞	真
𩳤	𩲒
罇	樽
擔著	担着
譴	谴
眎	视
跟著述	跟著述
鞵	鞋
子餘	子馀
空著稱	空著称
㘚	㘎
亞斯文	阿斯旺
盯著者	盯著者
乾亨	乾亨
下著称	下著称
挨著述	挨著述
向著者	向著者
誰	谁
著明	着明
持著錄	持著录
覆查	复查
璉	琏
㘭	坳
釐毫	厘毫
穢	秽
諾曼第	诺曼底
僅	仅
僂	偻
滿著	满着
於世成	於世成
著衣	着衣
僊	仙
放著	放着
戀著書	恋著书
僕	仆
枕著錄	枕著录
僑	侨
拿著錄	拿著录
望著者	望著者
螻	蝼
𩞄	𩠎
誥	诰
僥	侥
備著述	备著述
味著述	味著述
僨	偾
灑	洒
鬱姓	鬱姓
𩞯	䭪
僱	雇
筧	笕
𩞦	𩠏
價	价
誠	诚
鬆	松
縧	绦
心著稱	心著称
帳務	账务
𦵏	葬
縬	𦈚
罵著錄	骂著录
縮	缩
展著者	展著者
班固著	班固著
縫	缝
高著述	高著述
縵	缦
戰著者	战著者
縷	缕
縱	纵
縲	缧
縳	䌸
總	总
績	绩
縹	缥
縺	𦈐
沉著書	沉著书
於祥玉	於祥玉
縎	𦈔
繙㠾	繙㠾
繞著錄	绕著录
縊	缢
縋	缒
縕	缊
身著書	身著书
縐	绉
縑	缣
縝	缜
縞	缟
縟	缛
芮氏規模	里氏震级
縛	缚
鬍	胡
乾清	乾清
轉著書	转著书
鵞	鹅
著雝	着雝
鵑	鹃
攣	挛
攢	攒
偷著稱	偷著称
懷著者	怀著者
披著錄	披著录
盯著	盯着
託庸	讬庸
鯝	鲴
麽氏	麽氏
乾渥	乾渥
鳼	𪉃
鳳	凤
鳲	鸤
攛	撺
鳷	𫛛
么弟	幺弟
鳴	鸣
鳩	鸠
攄	摅
本著錄	本著录
鳬	凫
藏著錄	藏著录
鳧	凫
攏	拢
矽	硅
乾断	乾断
回覆	回复
鑼	锣
㝠	冥
誘	诱
矯	矫
鑾	銮
沿著名	沿著名
鑹	镩
電視影集	电视系列剧
矙	瞰
蒐輯	搜辑
薰沐	熏沐
鬚	须
鞏	巩
矓	眬
悠著者	悠著者
鑵	罐
配著	配着
銀硃	银朱
矇	蒙
矁	瞅
懼	惧
戰著作	战著作
乾曜	乾曜
鬧	闹
鑱	镵
鞦	秋
密西根	密歇根
守著	守着
做著者	做著者
鞽	鞒
鞾	靴
𡢃	㛠
為著作	为著作
皁	皂
掙著稱	挣著称
於氏	於氏
鑭	镧
瓊	琼
得著作	得著作
皟	𤾀
纏著作	缠著作
求著稱	求著称
鞝	绱
提著錄	提著录
皚	皑
視微知著	视微知著
乾录	乾录
落著名	落著名
懷	怀
猶豫著	犹豫着
減	减
乾貞	乾贞
鬪	斗
著重	着重
懲	惩
刻著述	刻著述
鑤	刨
盛著者	盛著者
蘸著名	蘸著名
㼝	碗
披著名	披著名
渾	浑
二進位	二进制
乾顾	乾顾
𦕈	眇
冒著錄	冒著录
鑠	铄
測	测
守著書	守著书
福著書	福著书
得著名	得著名
掖著名	掖著名
乾顧	乾顾
照著述	照著述
咬著	咬着
溢著作	溢著作
著棋	着棋
梳著述	梳著述
昇天	升天
蜨	蝶
持著名	持著名
擺著名	摆著名
鬮	阄
敍	叙
蒙特內哥羅	黑山
福著稱	福著称
側著作	侧著作
男為乾	男为乾
蜆	蚬
瞧著者	瞧著者
跼促	局促
成效顯著	成效显著
管著者	管著者
灄	滠
希拉莉	希拉里
隨著名	随著名
懣	懑
踩著名	踩著名
維根斯坦	维特根斯坦
敵	敌
跳著	跳着
𧵳	䞌
伴著錄	伴著录
隷	隶
揮著名	挥著名
戰著錄	战著录
鎪	锼
蝨	虱
侶	侣
𨵸	𨸇
製	制
著號	着号
逆著書	逆著书
鑌	镔
數著錄	数著录
蠒	茧
敘	叙
嚷著稱	嚷著称
懷著錄	怀著录
徹	彻
鞀	鼗
趕著者	赶著者
乾淳	乾淳
保障著錄	保障著录
專著	专著
抬著述	抬著述
乘著名	乘著名
展著述	展著述
陪著書	陪著书
鍊錘	链锤
𨮂	𨱕
鑄	铸
尼日爾	尼日尔
俠	侠
提著作	提著作
毫釐	毫厘
了結他	了结他
著意	着意
定著者	定著者
揉著者	揉著者
皰	疱
管著書	管著书
下著述	下著述
公厘	毫米
奧區	奧区
與著者	与著者
攜帶型	便携式
溢著	溢着
綁著	绑着
裹著者	裹著者
見著者	见著者
𨊸	䢁
撼著作	撼著作
牽著名	牵著名
布蘭登堡	勃兰登堡
蝱	虻
嚷著	嚷着
搥胸頓足	搥胸顿足
筴	䇲
藉口	借口
積架	捷豹
欝	郁
蒐採	搜采
用著書	用著书
熗	炝
太空梭	航天飞机
結他	吉他
綁著作	绑著作
賓拉登	本拉登
動著書	动著书
甜著名	甜著名
𥖅	𥐯
罵著者	骂著者
查帳	查账
𨏠	𨐇
靠著	靠着
罩著述	罩著述
閉著作	闭著作
逆著稱	逆著称
馬爾地夫	马尔代夫
閽	阍
蝯	猿
鉕	钷
徵	征
杜拜	迪拜
保障著名	保障著名
牽著	牵着
𣙎	㭣
燒著稱	烧著称
徠	徕
蝸	蜗
䮫	𩨇
徧	遍
𣙜	榷
復	复
閑著	闲着
唱著名	唱著名
戀著名	恋著名
徑	径
㿧	𤽯
著格	着格
從	从
受著作	受著作
徃	往
勩	勚
喝著書	喝著书
蝕	蚀
列印	打印
後	后
鉗	钳
孟德爾頌	门德尔松
備著	备着
帶著錄	带著录
循著名	循著名
對著名	对著名
味著称	味著称
求著作	求著作
咪高峰	麦克风
暗著者	暗著者
努力著稱	努力著称
亮著	亮着
鬰	郁
著莫	着莫
跟著作	跟著作
譚	谭
著籍	着籍
傌	㐷
藏著述	藏著述
固著	固着
謭	谫
醬	酱
傖	伧
傑	杰
做著書	做著书
斥著名	斥著名
備	备
傚	效
拎著名	拎著名
帳單	账单
傢	家
阿布達比	阿布扎比
鏘	锵
守著稱	守著称
嵐	岚
傴	伛
騎著作	骑著作
𩝔	𩠋
傷	伤
裝著述	装著述
傳	传
傾	倾
財務長。	首席财务官。
湧	涌
𪂆	𪉎
索贊尼辛	索尔仁尼琴
湯	汤
蒙著名	蒙著名
乾健也	乾健也
超連結	超链接
與著	与着
鏐	镠
湼	涅
湊	凑
蓋亞那	圭亚那
看著作	看著作
甞	尝
乾为天	乾为天
湞	浈
因著《	因著《
因著〈	因著〈
坐著者	坐著者
雅著書	雅著书
裝著	装着
耮	耢
纏	缠
續	续
纍	累
纊	纩
演化論	进化论
纈	缬
挑著者	挑著者
纇	颣
耬	耧
醆	盏
纁	𫄸
擱	搁
𤳸	𤳄
纜	缆
薺	荠
辦著者	办著者
纘	缵
畢卡索	毕加索
纖	纤
纔	才
纓	缨
𥕥	𥐰
鱝	鲼
鱟	鲎
夢著述	梦著述
鱘	鲟
藏著者	藏著者
馬鞌	马鞍
𡅏	𠲥
暱	昵
鹽份	盐分
𦢈	𣍨
私隱	隐私
擲	掷
鱒	鳟
暫	暂
慣著稱	惯著称
鱉	鳖
接著錄	接著录
鱅	鳙
暢	畅
鱇	𩾌
朝著名	朝著名
鱂	鳉
暘	旸
著陸	着陆
鱸	鲈
鱺	鲡
辦著名	办著名
掖著述	掖著述
䁪	𥇢
黎克特制	里氏
鱭	鲚
暉	晖
鱮	𫚈
擋著名	挡著名
鱤	鳡
鱧	鳢
打著名	打著名
鱠	鲙
鱣	鳣
䁻	䀥
靱	韧
魎	魉
捆著作	捆著作
戀著稱	恋著称
么元	幺元
葉里溫	埃里温
演著名	演著名
印表機	打印机
瞖	翳
靦	腼
靨	靥
瞘	眍
么兒	幺儿
瞞	瞒
勵	励
瞜	䁖
抓著作	抓著作
瞤	𥆧
灘	滩
靜	静
唯讀	只读
瞭	了
來著者	来著者
糊塗帳	糊涂账
靂	雳
瞶	瞆
靄	霭
靆	叇
靉	叆
靈	灵
幹著稱	幹著称
瞼	睑
內聯陞	内联升
豐	丰
紮著錄	扎著录
鏨	錾
豔	艳
雅著者	雅著者
𨋢	䢂
豈	岂
拖著稱	拖著称
豎	竖
穫著	获着
𣠲	𣑶
身著稱	身著称
演著書	演著书
鏤	镂
乾象歷	乾象历
懷著書	怀著书
電晶體	晶体管
擺著者	摆著者
帳上	账上
豬	猪
涼著述	凉著述
澦	滪
鉄	铁
澤	泽
叫著者	叫著者
瞞著書	瞒著书
變著作	变著作
𪃏	𪉏
澩	泶
穿梭機	航天飞机
豎著錄	竖著录
望著稱	望著称
見微知著	见微知著
條	条
澱	淀
雜著稱	杂著称
澾	㳠
澇	涝
澆	浇
澅	𣶩
壼	壸
澁	涩
朝著錄	朝著录
蘿	萝
打著述	打著述
澗	涧
揮著者	挥著者
澐	沄
乾窦	乾窦
待著	待着
哭著稱	哭著称
鉆	钻
電視劇集	电视剧
朱淛	朱淛
宏碁	宏碁
彲	彨
幹著名	幹著名
仗著稱	仗著称
螿	螀
蘋婆	苹婆
彥	彦
盛著稱	盛著称
螢	萤
彠	彟
蘇	苏
彫	雕
蘆	芦
蘿拉	劳拉
東協	东盟
蘄	蕲
拉鍊	拉链
苦著錄	苦著录
彆	别
雜著作	杂著作
蘊	蕴
彌	弥
么篇	幺篇
乾基	乾基
彈	弹
螎	融
掌上壓	俯卧撑
轡	辔
數著者	数著者
連結他	连结他
櫟	栎
伊莉莎白	伊丽莎白
護著書	护著书
銑	铣
𨯅	䥿
愛著	爱着
批覆	批复
著慌	着慌
繞著稱	绕著称
味著作	味著作
傘	伞
｣	”
｢	“
驋	𩧯
乾贵士	乾贵士
高著称	高著称
釐正	厘正
蒐索	搜索
隔著名	隔著名
還帳	还账
偉	伟
櫨	栌
忍著書	忍著书
併	并
𩜦	𩠆
漢諾瓦	汉诺威
櫪	枥
莫三比克	莫桑比克
制著者	制著者
壟	垄
空著書	空著书
跳著錄	跳著录
昂著稱	昂著称
挨著作	挨著作
櫬	榇
夢著錄	梦著录
係	系
佔	占
𩜇	𩠉
謙	谦
乾竺	乾竺
著裝	着装
壚	垆
偽	伪
新著	新著
佇	伫
釀著錄	酿著录
森巴舞	桑巴舞
陋著作	陋著作
偵	侦
側	侧
閉著錄	闭著录
貝	贝
貟	贠
貞	贞
貙	䝙
貛	獾
貓	猫
貍	狸
爭著錄	争著录
走著稱	走著称
太空衣	宇航服
烏龍麵	乌冬面
貼	贴
貿	贸
嘠	嘎
銖	铢
債	债
貴	贵
買	买
貶	贬
朱有燉	朱有燉
忙著錄	忙著录
貳	贰
貲	赀
責	责
貯	贮
販	贩
貨	货
貫	贯
嘯	啸
貧	贫
龕	龛
負	负
疑著書	疑著书
動畫影集	系列动画片
關著	关着
低著作	低著作
撼著述	撼著述
拎著述	拎著述
踩著述	踩著述
祿	禄
淨	净
疊	叠
見著稱	见著称
買帳	买账
警戒著	警戒着
鄶	郐
櫱	蘖
戰著稱	战著称
撰著	撰著
困著者	困著者
龜	龟
蠶	蚕
頂著稱	顶著称
祕	秘
嘷	嗥
餻	糕
祘	算
得著述	得著述
循著者	循著者
追著	追着
蒔	莳
貢寮	贡寮
閉著者	闭著者
隔著錄	隔著录
信著称	信著称
𥸠	𥮋
𩰀	𩬤
摳	抠
傳著書	传著书
夢著名	梦著名
迴圈	循环
亮著稱	亮著称
龐	庞
複製人	克隆人
裹著書	裹著书
麴黴	曲霉
隻字片語	只字片语
悠著書	悠著书
踏著書	踏著书
喝著	喝着
𨽏	𨸘
癇	痫
笑著作	笑著作
磁軌	磁道
癄	憔
療	疗
摋	𢫬
餘慶	馀庆
乾景	乾景
癉	瘅
癈	废
霧	雾
乾晷	乾晷
霢	霡
癒	愈
癟	瘪
銜	衔
癘	疠
索馬利亞	索马里
癥	症
癤	疖
𡠹	㛿
癢	痒
鬉	鬃
癮	瘾
癭	瘿
癬	癣
癩	癞
護著述	护著述
配著作	配著作
著人	着人
史瓦濟蘭	斯威士兰
癲	癫
癱	瘫
癰	痈
發	发
響著書	响著书
繃著	绷着
個	个
倈	俫
倉	仓
倆	俩
大姊	大姐
倀	伥
𩓣	𩖕
開著錄	开著录
試著錄	试著录
謏	𫍲
倖	幸
倐	倏
擊	击
嘖	啧
侖	仑
倫	伦
嘔	呕
語著書	语著书
來	来
倸	睬
𩓐	脖
巴斯拉	巴士拉
濤	涛
跑著名	跑著名
濧	㳔
藏著作	藏著作
陞遷	升迁
本著	本着
朝乾夕惕	朝乾夕惕
濫	滥
濶	阔
濰	潍
濱	滨
濼	泺
濾	滤
郭子乾	郭子乾
嘜	唛
B型肝炎	乙型肝炎
潤著書	润著书
濄	㳡
濆	𣸣
摑	掴
濁	浊
拉著者	拉著者
濃	浓
𪀦	𪉅
唱著錄	唱著录
簞	箪
𪀾	𪉋
濕	湿
騎著述	骑著述
戴著	戴着
哭著述	哭著述
濟	济
濘	泞
書	书
鰣	鲥
鰠	鳋
鰧	䲢
鰤	𫚕
鰥	鳏
𦣎	𦟗
鰨	鳎
鰩	鳐
鰮	鳁
鰭	鳍
鰲	鳌
枕著述	枕著述
鰱	鲢
噁心	恶心
𡄔	𠴢
鰵	鳘
候著錄	候著录
鰻	鳗
鰹	鲣
乾造	乾造
曥	𣆐
鰼	鳛
鰂	鲗
鰃	鳂
𡄣	𠵸
鰁	鳈
鰆	䲠
乾通	乾通
謊	谎
鰈	鲽
鰉	鳇
銃	铳
鰏	鲾
哥德式	哥特式
罩著作	罩著作
鰒	鳆
鰓	鳃
閻懷禮	闫怀礼
簒	篡
待著書	待著书
鰛	鳁
曄	晔
鰟	鳑
鰜	鳒
曇	昙
㝛	宿
將軍抽俥	将军抽俥
用著者	用著者
瞧著	瞧着
提著者	提著者
戔	戋
定著錄	定著录
瞞著述	瞒著述
蒙著作	蒙著作
藉故	借故
冪	幂
皺著	皱着
裹著錄	裹著录
腡	脶
著他	着他
乾昧	乾昧
醯醬	醯酱
伴著作	伴著作
瘍	疡
求著述	求著述
雜著書	杂著书
瘋	疯
瘖	喑
著什	着什
台北韓	台北韩
釐革	厘革
瘞	瘗
盯著名	盯著名
醯醋	醯醋
瘧	疟
仇讎	仇雠
瘡	疮
簽	签
瘮	瘆
乾明	乾明
掃瞄器	扫描仪
著令	着令
來著書	来著书
瘺	瘘
瘻	瘘
賢	贤
賣	卖
賠	赔
飀	飗
賦	赋
賧	赕
賤	贱
質	质
賫	赍
蕭乾	萧乾
腖	胨
賬	账
飃著	飘着
甜著稱	甜著称
賰	䞐
螢屏	荧屏
么爸	幺爸
么爹	幺爹
么爺	幺爷
賵	赗
賺	赚
賻	赙
賾	赜
男性为乾	男性为乾
賽	赛
賂	赂
賃	赁
賀	贺
賁	贲
逼著	逼着
賄	贿
賅	赅
賊	贼
活著	活着
賈	贾
瞪著述	瞪著述
轉著	转着
試著者	试著者
賒	赊
賓	宾
賑	赈
語著錄	语著录
公帳	公账
牽著述	牵著述
賚	赉
賛	赞
賙	赒
賞	赏
賟	𧹖
賜	赐
愴	怆
蟶	蛏
朝著者	朝著者
蟲	虫
愷	恺
㱃	饮
駕著者	驾著者
讎問	雠问
蟻	蚁
格林美獎	格莱美奖
張	张
沿著稱	沿著称
乾荫	乾荫
守著作	守著作
麗著錄	丽著录
蟯	蛲
乾圖	乾图
伊東豊雄	伊东丰雄
鬥著者	斗著者
行著	行着
陽為乾	阳为乾
米瀋	米渖
弒	弑
罩著稱	罩著称
弔	吊
蟇	蟆
蟄	蛰
耀著稱	耀著称
𨊰	䢀
蟁	蚊
蟎	螨
認帳	认账
浮著述	浮著述
蟈	蝈
飪	饪
悶著	闷着
借著稱	借著称
愛著書	爱著书
苦著名	苦著名
黌	黉
著眼	着眼
𩷰	𩾄
隔著者	隔著者
偵蒐	侦搜
冄	冉
嶮	崄
狽	狈
權	权
背著	背着
受著述	受著述
黏著書	黏著书
騖	骛
飄著者	飘著者
躺著名	躺著名
得著	得着
十進位制	十进位制
棟	栋
飄著作	飘著作
曆	历
㜏	㛣
護著錄	护著录
心著	心着
語著者	语著者
據著	据着
著想	着想
飤	饲
數碼電視	数字电视
隴	陇
紮著者	扎著者
《易乾	《易乾
欅	榉
㜷	𡝠
欄	栏
不著述	不著述
側著稱	侧著称
圍著書	围著书
輅	辂
㜢	𡞱
俻	备
乾神	乾神
燒著者	烧著者
持著作	持著作
慣著書	惯著书
葛萊美獎	格莱美奖
定著稱	定著称
母音	元音
乾祐	乾祐
坐著述	坐著述
筆	笔
安哈特	安哈尔特
著警	着警
愛	爱
俥	伡
喝著稱	喝著称
執	执
浮著書	浮著书
𨶏	𨸊
坐著	坐着
鯄	𩾁
銲	焊
埡	垭
吊著	吊着
聖文森及格瑞那丁	圣文森特和格林纳丁斯
飴	饴
礱	砻
黨	党
勱	劢
陋著	陋着
𨊻	𨐆
欵	款
程式設計師	程序员
哥斯大黎加	哥斯达黎加
營運長。	首席运营官。
礦	矿
營運長、	首席运营官、
礪	砺
礫	砾
礬	矾
騠	𫘨
礮	炮
礒	𥐟
軟體動物	软体动物
聽著錄	听著录
礙	碍
皷	鼓
陈公乾生	陈公乾生
礄	硚
跟著者	跟著者
鱔	鳝
黷	黩
來著	来着
鱗	鳞
礎	础
斯堪地那維亞	斯堪的纳维亚
騚	𩨊
鷥	鸶
鱖	鳜
輮	𫐓
鷯	鹩
掙著錄	挣著录
黴	霉
睡著名	睡著名
輭	软
鷨	𪉊
昬	昏
跳著者	跳著者
輬	辌
鷳	鹇
鷲	鹫
鷰	燕
當著書	当著书
𧶧	䞎
綃	绡
鷺	鹭
鷹	鹰
乾文	乾文
鷄	鸡
代表著名	代表著名
鷁	鹢
本著名	本著名
掖著作	掖著作
𧶔	𧹓
考著述	考著述
鷊	鹝
鷈	䴘
鷗	鸥
鷖	鹥
鷔	𪉑
鷓	鹧
定著	定着
踩著稱	踩著称
活著名	活著名
想著名	想著名
鷙	鸷
鱈	鳕
員	员
著艦	着舰
斯洛維尼亞	斯洛文尼亚
咖哩	咖喱
𩶘	䲞
象乾	象乾
𠕅	再
著色	着色
瞪著書	瞪著书
鄖	郧
綁	绑
𨶮	𨸌
𩶱	𩽽
𩶰	𩽿
闇公	闇公
守著者	守著者
鐋	铴
綀	𦈌
釀著述	酿著述
掖著稱	掖著称
盌	碗
乾旦	乾旦
盃	杯
騍	骒
著麼	着么
盇	盍
盜	盗
盞	盏
乾鹊	乾鹊
穿著名	穿著名
鐍	𫔎
沉著名	沉著名
戴著作	戴著作
盪	荡
望著述	望著述
疑著者	疑著者
輳	辏
監	监
暗著	暗着
盤	盘
盧	卢
瞞著稱	瞒著称
酒麴	酒曲
钁	镢
钂	镋
騅	骓
跟著錄	跟著录
代表著述	代表著述
𪁈	𪉉
資訊時代	信息时代
漬	渍
漣	涟
漢	汉
趨	趋
立著作	立著作
漸	渐
背著書	背著书
亮著述	亮著述
漿	浆
擋著者	挡著者
數著作	数著作
漵	溆
𪁖	𪉌
鐙	镫
乾靈	乾灵
得著錄	得著录
鱯	鳠
裹著	裹着
暈	晕
傳著者	传著者
抱著述	抱著述
厄瓜多尔	厄瓜多尔
貝里斯	伯利兹
擡著	抬着
本帳	本账
楈枒	楈枒
廻	回
廹	迫
提著稱	提著称
萲	萱
廵	巡
繫著	系着
廳	厅
萵	莴
崑調	昆调
氬	氩
諠譁	喧哗
邱吉爾	丘吉尔
廩	廪
萬	万
閑著書	闲著书
習	习
廣	广
廢	废
漁	渔
廠	厂
廟	庙
廝	厮
塋	茔
肉乾乾	肉干干
廕	荫
乾坤	乾坤
亮著錄	亮著录
廎	庼
臨著稱	临著称
廈	厦
廄	厩
萇	苌
廂	厢
廁	厕
鶥	鹛
崑蘇	昆苏
執著	执著
倣	仿
嬋	婵
鶬	鸧
著身	著身
鶩	鹜
鋪著者	铺著者
鶴	鹤
䜀	䜧
鶲	鹟
鶼	鹣
拉著書	拉著书
乾泉	乾泉
鶹	鹠
鶺	鹡
鶻	鹘
鶄	䴖
趙	赵
光著者	光著者
逼著錄	逼著录
鶉	鹑
鶊	鹒
糖份	糖分
拎著作	拎著作
鶒	𫛶
鶓	鹋
哭著	哭着
鶘	鹕
鶚	鹗
痐	蛔
時	时
䎱	䎬
惱	恼
身著錄	身著录
晉	晋
惲	恽
𥨐	𥧂
著急	着急
蒙著者	蒙著者
頂著作	顶著作
晝	昼
乾暉	乾晖
吃著	吃着
籤	签
看著名	看著名
高著稱	高著称
記著名	记著名
乘著錄	乘著录
求著名	求著名
開著者	开著者
翶	翱
點著	点着
有著	有着
吹著錄	吹著录
C型肝炎	丙型肝炎
鬥著	斗着
貪	贪
渴著者	渴著者
接著述	接著述
考著書	考著书
𨎮	𨐉
搥打	搥打
帶著書	带著书
贇	赟
贅	赘
贄	贽
贃	𧹗
身著者	身著者
贏	赢
銥	铱
贍	赡
屭	屃
贋	赝
贊	赞
戴著者	戴著者
贈	赠
贗	赝
贖	赎
贔	赑
仗著書	仗著书
贑	赣
配著述	配著述
贜	赃
贛	赣
騙著名	骗著名
與著書	与著书
蘸著	蘸着
踩著作	踩著作
穿著稱	穿著称
側著名	侧著名
逕迎	径迎
聖克里斯多福及尼維斯	圣基茨和尼维斯
別著	别着
循著錄	循著录
硯	砚
秖	只
讎正	雠正
印著錄	印著录
懷著作	怀著作
嬭	奶
騎著	骑着
罩著名	罩著名
秌	秋
帶著者	带著者
打著稱	打著称
光著名	光著名
秊	年
庽	寓
交帳	交账
直昇	直升
耶加達	雅加达
庻	庶
揮著稱	挥著称
硨	砗
昇平	升平
葷	荤
綁著稱	绑著称
葯	药
葠	参
蘊涵著	蕴涵着
葤	荮
𣝕	𣘷
葦	苇
㳒	法
愛護著	爱护着
蘇利南	苏里南
虧	亏
葒	荭
忙著作	忙著作
葉	叶
銪	铕
達著述	达著述
信著稱	信著称
著積	着积
伴著述	伴著述
據著書	据著书
蒙著書	蒙著书
著花	着花
乘著作	乘著作
駕著稱	驾著称
吹著	吹着
𩵹	𩽻
閉著稱	闭著称
飭令	飭令
模里西斯	毛里求斯
醜著	丑着
𥵊	𥭉
帶著名	带著名
蒐證	搜证
披著稱	披著称
寬	宽
𥵃	𥱔
易经乾	易经乾
拾瀋	拾渖
乘著	乘着
㥦	惬
䌝	𦈟
瀋	沈
垜	垛
馹	驲
著絆	着绊
柴契爾	撒切尔
貝爾格勒	贝尔格莱德
並	并
丣	卯
墾	垦
著絲	着丝
瀇	㲿
美著称	美著称
稜	棱
順著名	顺著名
職份	职分
十進位	十进制
隨著錄	随著录
盯著述	盯著述
光著錄	光著录
潤	润
卓著	卓著
拙著	拙著
乘著書	乘著书
睹微知著	睹微知著
綁著書	绑著书
潷	滗
么女	幺女
潰	溃
西臺王	赫梯王
男性為乾	男性为乾
潄	漱
跟著名	跟著名
乾隆	乾隆
潁	颍
睡著者	睡著者
張法乾	张法乾
忍著	忍着
蒙著錄	蒙著录
管著	管着
八進位	八进制
氊	毡
智慧財產權	知识产权
潑	泼
禿	秃
幀	帧
訣	诀
禱	祷
醯醢	醯醢
禮	礼
禡	祃
禦	御
么麼	幺麽
學姊	学姐
尋著錄	寻著录
訢	䜣
穀旦	穀旦
禕	祎
吃衣著飯	吃衣著饭
瞭望	瞭望
借著書	借著书
辦著	办着
禍	祸
逕入	径入
視著者	视著者
圍著稱	围著称
鵪	鹌
䝔	獾
乾生元	乾生元
鵯	鹎
鵮	鹐
鵡	鹉
幫著述	帮著述
循著稱	循著称
運算元	算子
么舅	幺舅
沖帳	冲账
御姊	御姐
鵾	鹍
鵰	雕
鵲	鹊
鵷	鹓
鵶	鸦
虛	虚
鰍	鳅
鵁	䴔
鵃	鸼
鵂	鸺
䝼	䞍
芮氏4	里氏4
芮氏5	里氏5
芮氏6	里氏6
芮氏7	里氏7
芮氏0	里氏0
芮氏1	里氏1
芮氏2	里氏2
芮氏3	里氏3
薰習	熏习
鵐	鹀
看著	看着
鵒	鹆
芮氏8	里氏8
芮氏9	里氏9
雜著錄	杂著录
踩著者	踩著者
鑿	凿
鬱氏	鬱氏
麴	麹
𩽇	𩾎
西臺語	赫梯语
鑷	镊
數碼訊號	数字信号
鑰	钥
開著作	开著作
鑲	镶
乾施	乾施
𦍑	羌
皜	皓
璵	玙
乾方	乾方
豶	豮
鑥	镥
諾	诺
乾斷	乾断
著位	着位
揮著錄	挥著录
鑣	镳
字型大小	字号
𦂅	𦈒
鑞	镴
鑛	矿
鑚	钻
鑕	锧
鑔	镲
裹著作	裹著作
巴貝多	巴巴多斯
鑑	鉴
鑒	鉴
著你	着你
悠著作	悠著作
皺	皱
幟	帜
皸	皲
鑊	镬
賓·拉登	本·拉登
蝟	猬
鴆	鸩
鑀	锿
訥	讷
璽	玺
纏著書	缠著书
赬	赪
甚夥	甚夥
銶	𨱇
幣	币
頻寬	带宽
稬	糯
𨏥	𨐊
鋝	锊
順著	顺着
摟著稱	搂著称
轉著稱	转著称
豎著書	竖著书
氣	气
寫著者	写著者
鍾愛	钟爱
𧔥	𧒭
邁	迈
鋇	钡
塞席爾	塞舌尔
住著作	住著作
鍾意	钟意
梲	棁
反覆	反复
漫著者	漫著者
展著	展着
么妹	幺妹
乾乾脆脆	干干脆脆
氫	氢
美著書	美著书
邇	迩
昂著	昂着
清澈	清澈
側著書	侧著书
斥著者	斥著者
想著作	想著作
掙著者	挣著者
梔	栀
鋏	铗
茘	荔
梟	枭
本著述	本著述
璫	珰
卹	恤
掃	扫
飄著述	飘著述
波里活	宝莱坞
澮	浍
隔著稱	隔著称
蒼	苍
毀	毁
蒙著稱	蒙著称
活著述	活著述
緼	缊
靠著稱	靠著称
視著作	视著作
苦著稱	苦著称
易经·乾	易经·乾
𪃍	𪉐
擺著錄	摆著录
聽著述	听著述
領著書	领著书
慶餘	庆馀
蒞	莅
沈默	沉默
混帳	混账
比較顯著	比较显著
諝	谞
蒓	莼
陆徵祥	陆徵祥
挨著	挨着
蒙特婁	蒙特利尔
代表著作	代表著作
光著稱	光著称
財	财
著哩	着哩
提著	提着
跳著作	跳著作
逼著者	逼著者
走著	走着
應著者	应著者
藉此	借此
印著述	印著述
掛著	挂着
僉	佥
躍著書	跃著书
枱	台
㞞	𪨊
抓著稱	抓著称
煙	烟
諏	诹
參	参
乾	干
乹	干
么正	幺正
諍	诤
坐著作	坐著作
獲著者	获著者
笑著錄	笑著录
褘	袆
藎	荩
美著稱	美著称
乾卦	乾卦
行著稱	行著称
鋯	锆
坿	附
澀	涩
𤋮	熙
鑽	钻
梳著稱	梳著称
衣著名	衣著名
什勒斯維希	石勒苏益格
臨著書	临著书
鐃	铙
矽尘	矽尘
姍	姗
鐄	𨱑
訒	讱
鐎	𨱓
鐏	𨱔
站著者	站著者
鐒	铹
鐓	镦
鐐	镣
乾一坛	乾一坛
鐔	镡
波士尼亞	波斯尼亚
鐘	钟
制著錄	制著录
煉	炼
鐝	镢
獲著作	获著作
鐠	镨
鐦	锎
鐧	锏
鐥	䦅
鐫	镌
解析度	分辨率
趂	趁
鐮	镰
鐯	䦃
鐲	镯
鐳	镭
不著名	不著名
瞭臺	瞭台
鐵	铁
鐺	铛
鐸	铎
趕	赶
鐿	镱
黏著錄	黏著录
昂著錄	昂著录
抓著名	抓著名
鮸	𩾃
樂著錄	乐著录
𦃄	𦈗
拿著	拿着
𤨏	琐
硤	硖
縣	县
硜	硁
閆	闫
於哲	於哲
管著作	管著作
陳堵	陳堵
應著稱	应著称
幃	帏
制著述	制著述
幇	帮
軒	轩
謝肇淛	谢肇淛
幑	徽
對著作	对著作
幗	帼
靚	靓
幙	幕
幘	帻
幚	帮
西臺國	赫梯国
牽著者	牵著者
門	门
姪	侄
幫	帮
幬	帱
著稱	著称
幹	干
展著書	展著书
著稿	着稿
身分	身份
說著	说着
幾	几
煒	炜
煑	煮
蘸著稱	蘸著称
煗	暖
煥	焕
雛	雏
派屈克	帕特里克
著己	着己
數著述	数著述
吐瓦魯	图瓦卢
附著錄	附著录
乾城	乾城
煩	烦
雅著名	雅著名
螡	蚊
煱	㶽
著便	着便
趕著書	赶著书
乾姓	乾姓
男为乾	男为乾
煢	茕
乾始	乾始
乾姊	干姐
擋著錄	挡著录
僞	伪
捆著者	捆著者
姊夫	姐夫
閃	闪
煬	炀
