出征收	出征收
定著称	定著稱
余食	餘食
八蜡	八蜡
一面食	一面食
嬖幸	嬖倖
著緊	着緊
流著述	流著述
合府上	合府上
场	場
圹	壙
时间不准	時間不準
單眼相機	單鏡反光機
布光	佈光
锦绣花园	錦綉花園
圣	聖
开辟	開闢
恋恋不舍	戀戀不捨
争	爭
想著錄	想著錄
亏	虧
于	於
云	雲
亚	亞
凶猛	兇猛
爭著名	爭著名
干仗	幹仗
注疏	註疏
产	產
亩	畝
瞪著	瞪着
检	檢
棁	梲
棂	欞
亲	親
亵	褻
古语云	古語云
竖	豎
抱著	抱着
席卷	席捲
亿	億
奇丑	奇醜
雅著述	雅著述
托辞	託辭
懷著述	懷著述
渴著名	渴著名
树梁	樹樑
浒	滸
于洋	于洋
采买	採買
制备	製備
遍佈著	遍佈着
搭伙	搭夥
醜著者	醜著者
圆	圓
保险柜	保險柜
三统历	三統曆
涼著者	涼著者
㑩	儸
间不容发	間不容髮
孫杰	孫杰
𧳕	𧳟
小价	小价
郁郁	鬱郁
千只够	千只夠
二里头	二里頭
制著名	制著名
㑈	倲
頁面	頁面
小仆	小僕
布谷	布穀
渴著書	渴著書
乔岳	喬嶽
背著名	背著名
泡制	泡製
托交	託交
穿著作	穿著作
侵占	侵佔
㑔	㑯
月裡来	月裏來
騰格里	騰格里
天地志狼	天地志狼
贵价	貴价
济	濟
征候	徵候
于震中	於震中
开吊	開弔
浍	澮
懈松	懈鬆
版图里	版圖裡
于帅	于帥
测	測
猜著作	猜著作
浈	湞
几榻	几榻
酦	醱
忍著述	忍著述
了然	瞭然
博尔术	博爾朮
斗合	鬥合
征招	徵招
裹著述	裹著述
夸下海口	誇下海口
有征服	有征服
奸污	姦污
隔著書	隔著書
广部	广部
修筑后	修築後
斗丽	鬥麗
扛著作	扛著作
嫩姜	嫩薑
伙友	夥友
夢著稱	夢著稱
敢干	敢幹
達著作	達著作
于康震	于康震
经文里	經文裡
中型钟面	中型鐘面
反冲	反衝
咸味	鹹味
爭著書	爭著書
好斗	好鬥
㻅	璯
笑著述	笑著述
干姊	乾姊
疑系	疑係
绥棱	綏稜
干姜	乾薑
对表演	對表演
揭丑	揭醜
夢有五不占	夢有五不占
留发生	留發生
干姐	乾姐
陪吊	陪弔
爭著稱	爭著稱
擺著稱	擺著稱
里水镇	裏水鎮
竹几	竹几
哪里	哪裡
郑凯云	鄭凱云
乘著者	乘著者
好萊塢	荷里活
亮著称	亮著稱
敞著名	敞著名
蓟	薊
蓝	藍
蓣	蕷
蓠	蘺
蓦	驀
傻里傻气	傻裡傻氣
蓥	鎣
格莱美奖	格林美獎
赵惠后	趙惠后
当当网	當當網
挑著述	挑著述
抵牾	牴牾
刮得	颳得
活著稱	活著稱
绪余	緒餘
擊扑	擊扑
瞞著錄	瞞著錄
𣺽	𤁣
𣺼	灙
人行道	行人路
于佳卉	于佳卉
落著述	落著述
术	術
巴而术	巴而朮
万扎	萬紮
采砂场	採砂場
吊腰撒跨	弔腰撒跨
机	機
被发缨冠	被髮纓冠
罩著錄	罩著錄
昆仑	崑崙
干血浆	乾血漿
𠵸	𡄣
𠵾	㗲
杨雅筑	楊雅筑
内斗	內鬥
掣签	掣籤
征名责实	徵名責實
三只	三隻
卡斯楚	卡斯特羅
三周后	三周後
钟花	鐘花
谷城县	穀城縣
徐干	徐幹
胃里	胃裡
𩖖	顃
𩖕	𩓣
松了	鬆了
蜜里调油	蜜裡調油
斗而铸兵	鬥而鑄兵
郁悒	鬱悒
本著作	本著作
富余	富餘
水表示	水表示
獨立國協	獨聯體
耍斗	耍鬥
松些	鬆些
于忠肅集	于忠肅集
一出电影	一齣電影
睡得著	睡得着
砾	礫
砺	礪
砻	礱
智慧型	智能
立著	立着
扶余	扶餘
卫后庄公	衛後莊公
坚致	堅緻
面包住	面包住
土魯斯	圖盧茲
砜	碸
不著痕跡	不着痕跡
砚	硯
砖	磚
砗	硨
辟谣	闢謠
只要功夫深，铁杵磨成锈花针	只要功夫深，鐵杵磨成鏽花針
砀	碭
码	碼
盘回	盤迴
點著書	點著書
落著錄	落著錄
任何钟表	任何鐘錶
幫著作	幫著作
斗雪红	鬥雪紅
溢著者	溢著者
占萬	佔萬
擺布	擺佈
亸	嚲
葉叶琴	葉叶琴
短信	短訊
调准	調準
庆历	慶曆
向著作	向著作
髅	髏
划水	划水
䟢	躎
于飞	于飛
两天后	兩天後
于小伟	于小偉
髌	髕
叶志穗	叶志穗
看著稱	看著稱
信托贸易	信托貿易
心系农	心繫农
涂鸿钦	涂鴻欽
长	長
立范	立範
圍著者	圍著者
万历	萬曆
躺著稱	躺著稱
往复式	往復式
免征	免徵
多冲	多衝
莪术	莪朮
拗别	拗彆
挑著名	挑著名
丰滨乡	豐濱鄉
裹著名	裹著名
巩	鞏
巯	巰
䅉	稏
仆憎	僕憎
福著	福着
并行	並行
兰溪市	蘭谿市
罵著	罵着
邀天之幸	邀天之倖
埔子里	埔子里
侍仆	侍僕
樯	檣
崑曲	崑曲
游人	遊人
回廊	迴廊
愿朴	愿樸
复种	複種
游了	遊了
范文虎	范文虎
羟	羥
頂著述	頂著述
摟著述	摟著述
手冢治虫	手塚治虫
濑	瀨
浑朴	渾樸
于右任	于右任
作准	作準
𦝼	膢
霸占	霸佔
干奴才	乾奴才
干白儿	乾白兒
干贝	乾貝
制做	製做
蒙雾	濛霧
對著述	對著述
動著	動着
西岳	西嶽
于汉超	于漢超
干革命	幹革命
金表明	金表明
么娘	么娘
闯炼	闖鍊
披著書	披著書
地丑德齐	地醜德齊
撩斗	撩鬥
干货	乾貨
熊杰	熊杰
留发	留髮
只身上已	只身上已
孝惠后	孝惠后
揉著述	揉著述
干醋	乾醋
棱层	稜層
独占	獨佔
盛著作	盛著作
不断发	不斷發
丑史	醜史
聽著作	聽著作
尋著述	尋著述
騙著作	騙著作
布警	佈警
电子钟表	電子鐘錶
私下里	私下裡
复目	複目
斗别气	鬥彆氣
老面皮	老面皮
對著錄	對著錄
桑干	桑乾
立著（	立著（
窗明几亮	窗明几亮
丑逆	醜逆
恒基	恒基
评断发	評斷發
黃鈺筑	黃鈺筑
宏都拉斯	洪都拉斯
涼著書	涼著書
肥筑方言	肥筑方言
奂	奐
關著稱	關著稱
两周后	兩周後
唁吊	唁弔
㓥	劏
愈合	癒合
大英國協	英聯邦
怀里	懷裡
译注	譯註
咸、甜	鹹、甜
軟體家具	軟體家具
六个	六個
嚼谷	嚼穀
深山何处钟	深山何處鐘
一冲	一衝
瞞著名	瞞著名
狂牛症	瘋牛症
駕著作	駕著作
𨂺	𨈊
困兽之斗	困獸之鬥
复述	複述
拼著作	拼著作
划着独木舟	划着獨木舟
記錄著	記錄着
扎好根	扎好根
径启	逕啟
揪发	揪髮
鸡丝面	雞絲麵
借箸代筹	藉箸代籌
訚	誾
昂著者	昂著者
舍车保帅	捨車保帥
西湖里	西湖里
冲口	衝口
于贝尔	于貝爾
𩧭	䭿
趴著	趴着
秒表明	秒表明
蒙头转	矇頭轉
韩制	韓製
范性形变	範性形變
锌制	鋅製
拎著錄	拎著錄
这只采	這只採
天里昂	天里昂
馬格里布	馬格里布
雜著者	雜著者
扎脚	紮腳
诚朴	誠樸
浮著稱	浮著稱
旧金山	三藩市
大言非夸	大言非夸
账	賬
于正昇	于正昇
焙干	焙乾
于正昌	于正昌
钟下	鐘下
松手	鬆手
三征七辟	三徵七辟
搤肮	搤肮
干女	乾女
印著	印着
恂栗	恂慄
采煤	採煤
并兼	併兼
穿著錄	穿著錄
言云	言云
𣑶	𣠲
襕	襴
夸她	誇她
钟漏	鐘漏
饩	餼
來著作	來著作
毛发	毛髮
追著名	追著名
索羅門群島	所羅門群島
姜黄	薑黃
仆吏	僕吏
追凶	追兇
余四	餘四
前面店	前面店
惩忿窒欲	懲忿窒欲
中签署	中簽署
做著名	做著名
余沥	餘瀝
千只夠	千只夠
乌兹冲锋枪	烏茲衝鋒槍
珐琅	琺瑯
暗著書	暗著書
所托	所託
才干政	才干政
硬干	硬幹
捉奸党	捉奸黨
𠚳	𠠎
上系上	上繫上
孛里海	孛里海
干球温度	幹球溫度
蕰	薀
蕲	蘄
财	財
厄瓜多爾	厄瓜多爾
割占	割佔
活著者	活著者
烫面	燙麵
㑇	㑳
烹制	烹製
丑类	醜類
崑苏	崑蘇
诱奸	誘姦
躍著作	躍著作
圍著作	圍著作
丰滨	豐濱
秀发	秀髮
巴塞罗那	巴塞隆拿
可紧可松	可緊可鬆
颎	熲
周杰	周杰
注云	注云
𤆡	熓
記著書	記著書
贠	貟
荡然	蕩然
吊唁	弔唁
面包厢	面包廂
颂	頌
占了卜	占了卜
发及腰	髮及腰
繞著名	繞著名
穷追不舍	窮追不捨
𪚐	𪘯
甘比亞	岡比亞
调制	調製
陇	隴
桪	樳
脐	臍
桨	槳
桩	樁
体征	體徵
丑恶	醜惡
𪚏	𪘀
䴓	鳾
档	檔
桠	椏
騙著稱	騙著稱
䴗	鶪
桧	檜
公寓里	公寓裡
䴔	鵁
涌上	湧上
额我略历史	額我略歷史
内面包的	內面包的
凶犯	兇犯
颛	顓
性别扭曲	性別扭曲
循著	循着
龙岩	龍巖
专辑里	專輯裡
漫著作	漫著作
西臺人	赫梯人
总数只	總數只
查封后	查封後
向往时	向往時
乱斗	亂鬥
曲车	麴車
求著	求着
伐罪吊民	伐罪弔民
向往日	向往日
频	頻
纏著錄	纏著錄
IP地址	IP位址
焕	煥
附著者	附著者
悒郁	悒鬱
彩樓	綵樓
笑著	笑着
3字节	3位元組
驵	駔
驴	驢
驷	駟
求著錄	求著錄
驱	驅
驰	馳
驳	駁
驲	馹
驽	駑
圍著名	圍著名
驿	驛
碍	礙
驹	駒
驸	駙
驻	駐
䙓	襬
䙌	䙡
䙊	𧜵
驭	馭
马	馬
碜	磣
驮	馱
表慢	錶慢
睡著錄	睡著錄
苍术	蒼朮
游戏里	遊戲裡
沤郁	漚鬱
铲平	剷平
门德尔松	孟德爾遜
丑月	丑月
主干	主幹
碱	鹼
赈饥	賑饑
拉著稱	拉著稱
因著作	因著作
须胡	鬚鬍
阿拉伯聯合大公國	阿拉伯聯合酋長國
掙著	掙着
托古讽今	託古諷今
坐台	坐檯
几椅	几椅
堅貞著	堅貞着
斗闲气	鬥閒氣
干坏事	幹壞事
跳著稱	跳著稱
牽著稱	牽著稱
昆承湖	崑承湖
坤范	坤範
么半	么半
山岳	山嶽
冲盹	衝盹
辦著錄	辦著錄
漫游	漫遊
臨著者	臨著者
踌	躊
干涸	乾涸
7字节	7位元組
心系神	心繫神
慑	懾
珍肴异馔	珍肴異饌
心系祖	心繫祖
坐著稱	坐著稱
干涩	乾澀
舍己为国	捨己為國
钟不扣不鸣	鐘不扣不鳴
征风召雨	徵風召雨
轉著稱	轉著稱
記著錄	記著錄
膠著	膠着
下签	下籤
袋里	袋裡
脏器	臟器
么媽	么媽
占上風	佔上風
光致致	光緻緻
占世界	佔世界
催并	催併
犖确	犖确
抢占	搶佔
畫著作	畫著作
干屎橛	乾屎橛
冲激	衝激
聘雇	聘僱
布於	佈於
历书	曆書
模范三军	模范三軍
准噶尔	準噶爾
斗剑	鬥劍
于余曲折	于餘曲折
土索面	土索麵
表里如一	表裏如一
岸裡	岸裡
余珍	餘珍
于震后	於震後
敞著稱	敞著稱
于蔭霖	于蔭霖
谢丽·布莱尔	彭雪玲
㶉	鸂
蛮干	蠻幹
痳病	痳病
寄托在	寄托在
大风后	大風後
㶽	煱
𨷿	䦳
干鲜	乾鮮
㶶	燶
洞里	洞裡
聖馬利諾	聖馬力諾
棒子面	棒子麵
刚干	剛乾
百天后	百天後
保障著者	保障著者
精准	精準
轧	軋
于志宁	于志寧
吹著作	吹著作
后姓	后姓
冲堂	衝堂
制钟	制鐘
姜茶	薑茶
抚	撫
刻半钟	刻半鐘
于格	于格
分布于	分佈於
網路	網絡
干坞	乾塢
亚细安	東盟
发钗	髮釵
點著述	點著述
载	載
木制	木製
叫著書	叫著書
悫	愨
樂著者	樂著者
悮	悞
悭	慳
悬	懸
笔杆	筆桿
缩短发	縮短發
沙羡	沙羡
方便面	方便麵
于洪区	于洪區
心系何	心繫何
爆发	爆發
心系选	心繫選
制成	製成
复决	複決
齐王舍牛	齊王捨牛
汤面	湯麵
明目张胆	明目張胆
動著稱	動著稱
以自制	以自制
于归	于歸
复写	複寫
自制不	自制不
炆面	炆麵
陈炼	陳鍊
主钟差	主鐘差
心系你	心繫你
格瑞那達	格林納達
黏著稱	黏著稱
锏	鐧
锌	鋅
锍	鋶
打著書	打著書
锋	鋒
锈	銹
锉	銼
锆	鋯
锇	鋨
锄	鋤
锅	鍋
锂	鋰
锃	鋥
销	銷
锁	鎖
锞	錁
锟	錕
锜	錡
锝	鍀
锚	錨
锛	錛
锘	鍩
错	錯
锖	錆
锗	鍺
锔	鋦
锕	錒
锒	鋃
锓	鋟
锐	銳
锑	銻
键	鍵
锯	鋸
锬	錟
锭	錠
锪	鍃
锫	錇
锨	杴
锩	錈
锦	錦
锧	鑕
锤	錘
锥	錐
锢	錮
锣	鑼
锠	錩
锡	錫
锾	鍰
锿	鎄
锼	鎪
锽	鍠
锺	鍾
实验里	實驗裡
锸	鍤
锹	鍬
陋著名	陋著名
锷	鍔
锴	鍇
锵	鏘
锲	鍥
锳	鍈
锰	錳
锱	錙
戏里	戲裡
𨄄	𨈌
屏幕	螢幕
各类钟	各類鐘
卷袖	捲袖
冲破	衝破
语里	語裡
與著稱	與著稱
理一个发	理一個髮
这只限	這只限
结彩	結綵
于西翰	于西翰
心系风	心繫風
犯不著錄	犯不著錄
嗅得著	嗅得着
忍著者	忍著者
标注	標註
水表	水錶
亿只	億隻
里运河	裏運河
想著	想着
言里	言裡
跃	躍
嵝	嶁
9只支援	9只支援
天后宫	天后宮
嵘	嶸
嵚	嶔
颁布	頒佈
跞	躒
林郁方	林郁方
么雞	么雞
数天后	數天後
夢著書	夢著書
干擦	乾擦
不通吊庆	不通弔慶
持著者	持著者
发踊冲冠	髮踴沖冠
闲	閒
𫛸	鶗
發著《	發著《
抓著作	抓著作
菠棱菜	菠稜菜
泰坦尼克号	鐵達尼號
𫛶	鶒
拖著稱	拖著稱
灏	灝
闿	闓
兽欲	獸慾
關係著	關係着
枕著者	枕著者
养脏	養臟
轮奸	輪姦
蜂后	蜂后
灿	燦
灾	災
𫛞	鴃
百只可	百只可
鳃	鰓
灵	靈
考著者	考著者
管著名	管著名
闺	閨
小时里	小時裡
余力为	余力為
灭	滅
游丝	遊絲
于来山	于來山
雇农	僱農
沟大曲	溝大麯
于明涛	于明濤
嘤	嚶
书签	書籤
幫浦	泵
片言只语	片言隻語
小型钟表面	小型鐘表面
于永波	于永波
鹿場里	鹿場里
吉力馬札羅	乞力馬札羅
的钟	的鐘
嘱	囑
衣著者	衣著者
好凶	好兇
夸强说会	誇強說會
复列	複列
2只支援	2只支援
困觉	睏覺
这里	這裡
大伙儿	大伙兒
主仆	主僕
发肤	髮膚
游玩	遊玩
于熙珍	于熙珍
七扎	七紮
胡子	鬍子
发纱	髮紗
筑陽	筑陽
米面	米麵
注上	註上
㺍	獱
吊喉	弔喉
擋著述	擋著述
殷师牛斗	殷師牛鬥
占英	佔英
槠	櫧
著錄	着錄
犯不著作	犯不著作
占苏	佔蘇
槛	檻
钢梁	鋼樑
牽著述	牽著述
本著者	本著者
面包藏	面包藏
借著	借着
有只用	有只用
辦著作	辦著作
面食饭	面食飯
夏于乔	夏于喬
夸海口	誇海口
歌后	歌后
1余	1餘
采生折割	採生折割
卷来	捲來
轉著名	轉著名
布滿	佈滿
面人儿	麵人兒
都市里	都市裡
布满	佈滿
大钟	大鐘
信托	信託
甜、咸	甜、鹹
美著錄	美著錄
少采	少採
自制下来	自制下來
曼谷	曼谷
向慕	嚮慕
于氏	于氏
咖哩	咖喱
斗富	鬥富
分别致	分别致
壓著述	壓著述
颛顼历	顓頊曆
遇著書	遇著書
布谷鸟	布穀鳥
𧿈	𨇁
站著述	站著述
集里	集裡
睡著稱	睡著稱
沈丹铁路	瀋丹鐵路
占印	佔印
語著述	語著述
幸运胡	幸運鬍
桥梁	橋樑
太后	太后
占占	佔佔
舌干唇焦	舌乾唇焦
膠著作	膠著作
分布	分佈
人工智慧	人工智能
种师中	种師中
心系输	心繫輸
占南	佔南
聊斋志异	聊齋志異
烫个发	燙個髮
于秀敏	于秀敏
个中翘楚	箇中翹楚
有只采	有只採
占半	佔半
嫱	嬙
丑吒	醜吒
4字节	4位元組
丑三	丑三
占千	佔千
占十	佔十
謝杰	謝杰
乱	亂
游行	遊行
鉴谅	鑑諒
颤	顫
浚州	濬州
游街	遊街
通鉴	通鑑
直冲	直衝
鼻梁儿	鼻梁兒
自制她	自制她
维系	維繫
连发式	連發式
大折儿	大摺兒
冲心	衝心
班里	班裡
㭏	椲
菲利普親王	菲臘親王
天地为范	天地為範
𧒭	𧔥
上梁	上樑
賴比瑞亞	利比里亞
跟著	跟着
拼生尽死	拚生盡死
后髮星系團	后髮星系團
對着幹	對着幹
桂圆干	桂圓乾
夸称	誇稱
蚃	蠁
于斯纳尔斯贝里	于斯納爾斯貝里
㭤	樢
㭣	𣙎
多只需	多只需
叠席	疊蓆
几淨窗明	几淨窗明
窃钟掩耳	竊鐘掩耳
㭴	樫
帝后臺	帝后臺
八天后	八天後
啮齿类	嚙齒類
一并	一併
绑扎	綁紮
著涼	着涼
仆人	僕人
披著作	披著作
干瞪眼	乾瞪眼
对不准	對不準
秀发表	秀發表
蘭卡威	浮羅交怡
釀著稱	釀著稱
甜水面	甜水麵
老么	老么
鋪著稱	鋪著稱
干亲	乾親
寫著述	寫著述
宴游	宴遊
荦确	犖确
為著《	為著《
沙地阿拉伯	沙特阿拉伯
偷著者	偷著者
坎城	康城
采桑	採桑
于泽尔	于澤爾
干笑	乾笑
悠著稱	悠著稱
径寄	逕寄
古钟表	古鐘錶
橱	櫥
𩏼	䪏
𩏽	𩏪
𩏾	𩎢
𩏿	䪘
旋回	旋迴
寡欲	寡慾
藓	蘚
上签收	上簽收
顛顛仆仆	顛顛仆仆
布雷，	佈雷，
几几	几几
于堅	于堅
閉著書	閉著書
布雷；	佈雷；
空著	空着
几凳	几凳
定制	定製
手表	手錶
松化	鬆化
希冀著	希冀着
几出	幾齣
鬈发	鬈髮
于雙戈	于雙戈
兽	獸
怜	憐
一出剧	一齣劇
只身子	只身子
犯得著	犯得着
怅	悵
怄	慪
怆	愴
态	態
怀	懷
怃	憮
怂	慫
斥著稱	斥著稱
干刻版	乾刻版
后海湾	后海灣
玉米面	玉米面
画里	畫裡
拉著作	拉著作
怼	懟
怿	懌
祝发	祝髮
包括	包括
总	總
后印	後印
衣著	衣着
長几	長几
8只支援	8只支援
地志	地誌
钟琴	鐘琴
夺斗	奪鬥
条文里	條文裡
南京钟	南京鐘
九世之仇	九世之讎
于玉立	于玉立
趕著	趕着
并发布	並發布
童仆	童僕
炼石	鍊石
追著書	追著書
吃里爬外	吃裡爬外
帮	幫
懷著稱	懷著稱
數著稱	數著稱
皺著述	皺著述
隱私	私隱
于海上	於海上
回著	回着
荡产	蕩產
并发型模式	併發型模式
3周后	3周後
洗练	洗鍊
撒马尔罕	撒馬爾罕
干洗	乾洗
尼克松	尼克遜
强奸	強姦
荙	薘
扎寨	紮寨
荚	莢
栗冽	慄冽
干下去	幹下去
干活	幹活
笋	筍
只身邊	只身邊
踏著名	踏著名
坐著書	坐著書
笃	篤
索忍尼辛	索贊尼辛
瑞城里	瑞城里
東南亞國家協會	東南亞國家聯盟
笔	筆
共和联邦	英聯邦
心系沈	心繫沈
五峰县	五峯縣
缇	緹
党	黨
幫著錄	幫著錄
心系沙	心繫沙
并骨	併骨
笺	箋
笼	籠
笾	籩
下著名	下著名
5只	5隻
劫余	劫餘
峄	嶧
峃	嶨
烬余	燼餘
困兽犹斗	困獸猶鬥
音声如钟	音聲如鐘
发匪	髮匪
傧	儐
占據	佔據
峥	崢
峤	嶠
峣	嶢
坛騞	罈騞
峡	峽
印著名	印著名
于衡	于衡
辛巴威	津巴布韋
这出色	這出色
烧	燒
烦	煩
烩	燴
烨	燁
烫	燙
𥮜	䉲
热	熱
烬	燼
游侠	遊俠
台历	檯曆
未干	未乾
划到江心	划到江心
帘布	帘布
候著述	候著述
拎著	拎着
雇到	僱到
鸡丝	雞絲
烁	爍
只影響	只影響
烃	烴
烂	爛
拉面具	拉面具
国之桢干	國之楨榦
心系母	心繫母
占超过	佔超過
烛	燭
那只怕	那只怕
皮里阳秋	皮裡陽秋
征士	徵士
麦克风	咪高峰
陪著作	陪著作
丑丫头	醜丫頭
嚣	囂
涂爾幹	涂爾幹
滨	濱
模范七棒	模范七棒
赞不绝口	讚不絕口
采取	採取
鬼谷子	鬼谷子
眼帘	眼帘
一准	一準
党家	党家
钟的	鐘的
殺著	殺着
有余	有餘
谢杰	謝杰
打断发	打斷發
下著錄	下著錄
余僇	餘僇
怫郁	怫鬱
漓然	灕然
盛著	盛着
咸汤	鹹湯
接著者	接著者
击扑	擊扑
荦	犖
双折射	雙折射
师范	師範
杜老志道	杜老誌道
提高后	提高後
刑余	刑餘
应征	應徵
姜是老的辣	薑是老的辣
广舍	廣捨
所云云	所云云
自制情	自制情
立著称	立著稱
荣	榮
弄脏胸	弄髒胸
首出电影	首齣電影
聽著稱	聽著稱
映著作	映著作
放著稱	放著稱
捉奸	捉姦
不采声	不采聲
脔	臠
夸功	誇功
卷曲	捲曲
舊金山	三藩市
哭著錄	哭著錄
件钟	件鐘
嬉游	嬉遊
划桨	划槳
于澄	于澄
上台面	上檯面
榴莲	榴槤
批复	批覆
采料	採料
沈吉	瀋吉
短发生	短發生
罗纳尔迪尼奥	朗拿甸奴
印制	印製
𧹓	𧶔
𧹕	䝻
𧹖	賟
𧹗	贃
占台	佔台
托管	託管
沉著錄	沉著錄
百只够	百只夠
澈底	徹底
余三勝	余三勝
數著	數着
参数只	參數只
百只夠	百只夠
動著名	動著名
占取	佔取
冤仇	冤讎
丑事	醜事
卷积云	捲積雲
回复意见	回覆意見
征收	徵收
腊毒	腊毒
蒲隆地	布隆迪
种師中	种師中
管干	管幹
朴念仁	樸念仁
6余	6餘
枕著稱	枕著稱
卤五花	滷五花
斗牛星	斗牛星
尋著者	尋著者
刘芸后	劉芸后
年历次	年歷次
须生	鬚生
弥弥	瀰瀰
象徵著名	象徵著名
干得	幹得
有只採	有只採
銮	鑾
謹愿	謹愿
埚	堝
裝著稱	裝著稱
說著者	說著者
𤾀	皟
法占	法佔
托咎	託咎
凄厉	悽厲
達著	達着
學著	學着
点里	點裡
只身后	只身後
张乐于张徐	張樂于張徐
儒略历	儒略曆
叶叶琹	葉叶琹
𤈶	熉
愛著稱	愛著稱
拼斗	拚鬥
谷梁	穀梁
樂著述	樂著述
大周后	大周后
落腮胡	落腮鬍
这只比	這只比
钢之炼金术师	鋼之鍊金術師
喝著錄	喝著錄
韶山冲	韶山沖
領著	領着
并一不二	併一不二
吉布地	吉布堤
咙	嚨
4余	4餘
干热	乾熱
并发现	並發現
看著錄	看著錄
如饥似渴	如饑似渴
辔	轡
采集	採集
制盐	製鹽
1只支持	1只支持
笑著書	笑著書
伴著書	伴著書
塑料袋	膠袋
机械系	機械系
老仆	老僕
采证	採證
于小彤	于小彤
2字节	2位元組
楼	樓
横冲	橫衝
吃面	吃麵
下签名	下簽名
菜干	菜乾
剃须	剃鬚
黛安娜	戴安娜
閉著述	閉著述
采菊	採菊
瞞著作	瞞著作
回绕	迴繞
艰	艱
最多	最多
一干部下	一干部下
驶著	驶着
但云	但云
漓水	灕水
下著稱	下著稱
云吞	雲吞
复韵	複韻
复音	複音
賴索托	萊索托
晃著	晃着
守著錄	守著錄
4只支持	4只支持
2只	2隻
心系她	心繫她
征验	徵驗
夸父	夸父
游猎	遊獵
心系奥	心繫奧
叫著作	叫著作
喾	嚳
偷著錄	偷著錄
只身上有	只身上有
夾著者	夾著者
喷	噴
余人	餘人
扛著錄	扛著錄
辊	輥
喂	餵
辌	輬
照相干片	照相乾片
谚	諺
汤滷	汤滷
苦里	苦裡
机械钟	機械鐘
一树百获	一樹百穫
葡占	葡佔
7只	7隻
凶疑	兇疑
藤制	藤製
数只需	數只需
燒著錄	燒著錄
座钟	座鐘
沈丹客运	瀋丹客運
天后半	天後半
紧致	緊緻
儉确之教	儉确之教
西臺帝	赫梯帝
络腮胡	絡腮鬍
臨著作	臨著作
于震环	于震環
足球台	足球台
团	團
面包著	面包着
呦喂	呦喂
語有云	語有云
旧游	舊遊
䌷	紬
百扎	百紮
挂面	掛麵
戰著書	戰著書
宁	寧
该钟	該鐘
长发妹	長髮妹
儒略改革历史	儒略改革歷史
辟邪以律	闢邪以律
䌻	䋚
戴著錄	戴著錄
公孙丑	公孫丑
慣著錄	慣著錄
䌺	䋙
染发	染髮
宝	寶
实	實
宠	寵
审	審
鸣钟	鳴鐘
多只有	多只有
小只需	小只需
繁复	繁複
多只會	多只會
宪	憲
美著	美着
电表	電錶
晶體管	電晶體
斗鹌鹑	鬥鵪鶉
宽	寬
宾	賓
印著稱	印著稱
于晨楠	于晨楠
整风后	整風後
咸鱼	鹹魚
斫雕为朴	斫雕為樸
简	簡
用著作	用著作
8只	8隻
忙里	忙裡
厄利垂亞	厄立特里亞
有著錄	有著錄
厄利垂亚	厄立特里亞
卷瓣	捲瓣
悬挂	懸掛
冲冠发怒	沖冠髮怒
谜	謎
箦	簀
箧	篋
箪	簞
甜著作	甜著作
晃著錄	晃著錄
箩	籮
心系民	心繫民
上签发	上簽發
舍不得	捨不得
希伯来历	希伯來曆
梳著	梳着
仗著錄	仗著錄
梦有五不占	夢有五不占
真个	真箇
夢著作	夢著作
𡭬	𡮣
尸魂界	尸魂界
这只不过	這只不過
钟口	鐘口
轻松松	輕鬆鬆
乌苏里	烏蘇里
回文序列	迴文序列
夸能	誇能
干着急	干着急
幽并	幽并
桌历史	桌歷史
胜鍵	胜鍵
制剂	製劑
谒	謁
干警	幹警
朦胧	朦朧
鼻梁	鼻樑
巧干	巧幹
合准	合準
模制	模製
努力著述	努力著述
于树洁	于樹潔
涂尔干	涂爾幹
尸祿	尸祿
批准	批准
伊达里子	伊達里子
征辟	徵辟
吐哺握发	吐哺握髮
胡里胡涂	胡裡胡塗
划艇	划艇
頂著者	頂著者
台布	檯布
仆婢	僕婢
茶几	茶几
征求	徵求
签押	籤押
尸祝	尸祝
制著書	制著書
戰著名	戰著名
须根据	須根據
发屋	髮屋
㭎	棡
评注	評註
夸来夸去	誇來誇去
于靖	于靖
口里	口裡
余庆	餘慶
自制伏	自制伏
舍短取长	捨短取長
有栖川	有栖川
矮几	矮几
干花	乾花
月面	月面
荡平	蕩平
雪窗螢几	雪窗螢几
苍发	蒼髮
网志	網誌
雅著錄	雅著錄
有著名	有著名
騎著者	騎著者
自制力	自制力
偷著名	偷著名
鹤吊	鶴弔
載著者	載著者
郁挹	鬱挹
回递性	迴遞性
之鉴	之鑑
制取	製取
争奇斗妍	爭奇鬥妍
龙须面	龍鬚麵
桤	榿
揉著稱	揉著稱
命中注定	命中注定
配著名	配著名
不干胶	不乾膠
因著名	因著名
順著者	順著者
隨著者	隨著者
干父之蛊	幹父之蠱
衅	釁
記著述	記著述
余烈	餘烈
附著	附着
皆可作淀	皆可作澱
美著名	美著名
净发	淨髮
余烬	餘燼
余热	餘熱
批注	批註
盗采	盜採
冲坚陷阵	衝堅陷陣
尖峰時段	繁忙時段
淑范	淑範
包扎	包紮
魇	魘
魉	魎
過著	過着
谨愿	謹愿
径自	逕自
厣	厴
心系摩	心繫摩
么鳳	么鳳
准的	準的
霍爾斯坦	荷爾斯泰因
丰神	丰神
建筑后	建築後
硵	磠
数只有	數只有
冲天	沖天
吊孝	弔孝
著手	着手
心系乔	心繫喬
讫	訖
壶里	壺裡
媭	嬃
截发	截髮
金表达	金表達
瓦倫西亞	華倫西亞
動著述	動著述
咸卤	鹹鹵
黄历	黃曆
只身形	只身形
阴郁	陰鬱
被系上	被繫上
葉叶琹	葉叶琹
雪里红	雪裡紅
辰溪县	辰谿縣
被发佯狂	被髮佯狂
妆台	妝檯
沿著述	沿著述
划子	划子
浮著作	浮著作
配著錄	配著錄
抽签	抽籤
著忙	着忙
任何钟	任何鐘
開著	開着
呂后	呂后
幅图里	幅圖裡
钟敲	鐘敲
打著	打着
担担面	擔擔麵
丑诋	醜詆
向著	向着
干弟	乾弟
井干	井幹
演著者	演著者
于远伟	于遠偉
丑侪	醜儕
蜡祭	蜡祭
丑话	醜話
垄	壟
一斗斗	一斗斗
𩠠	𩠴
星罗棋布	星羅棋佈
托名	託名
铁制	鐵製
印著者	印著者
回著名	回著名
征信	徵信
蘸著書	蘸著書
𩠅	𩟐
讠	訁
𩠇	䭀
伯明罕	伯明翰
𩠁	𩚵
𩠀	𩚥
開誠布公	開誠佈公
𩠂	𩛆
让	讓
𩠌	餸
里海大學	里海大學
𩠎	𩞄
𩠉	𩜇
𩠈	䭃
𩠋	𩝔
议	議
讱	訒
记	記
讳	諱
逆著	逆着
戀著	戀着
讴	謳
讷	訥
尋著名	尋著名
讹	訛
许	許
讻	訩
论	論
讽	諷
讼	訟
访	訪
设	設
凶案	兇案
淀积	澱積
抬著者	抬著者
属	屬
谂	諗
脚注	腳註
屉	屜
接著稱	接著稱
届	屆
杠轂	杠轂
屃	屓
占据	佔據
个中强手	箇中強手
潤著者	潤著者
受著者	受著者
屿	嶼
干旱	乾旱
載著書	載著書
逍遥游	逍遙遊
于幼军	于幼軍
切尔诺贝利	切爾諾貝爾
牛只	牛隻
屡	屢
屦	屨
于从濂	于從濂
𥬞	籋
獭	獺
游伴	遊伴
千只怕	千只怕
手表態	手表態
犯不著稱	犯不著稱
係數	系數
赞叹	讚嘆
髋	髖
风后	風后
錢尼	切尼
窑	窯
𥬀	䉙
明征	明徵
䭪	𩞯
努力著名	努力著名
坐钟	坐鐘
占网	佔網
看表	看錶
棉里	棉裡
過著名	當著名
夸饰	誇飾
仙后	仙后
睐	睞
对着干	對着幹
癸丑	癸丑
唢	嗩
唠	嘮
唡	啢
唤	喚
哈囉喂	哈囉喂
发已霜白	髮已霜白
说不准	說不準
准则	準則
脉冲	脈衝
余七	餘七
土里	土裡
唛	嘜
吁天	籲天
余三	餘三
唝	嗊
綁著述	綁著述
电脑程序	電腦程式
校准	校準
于海边	於海邊
谄	諂
余业	餘業
急著者	急著者
碗里	碗裡
䲟	鮣
柜里	櫃裡
來著稱	來著稱
准分子	準分子
达芬奇	達文西
系恋	繫戀
巅	巔
借著者	借著者
羅亞爾	盧瓦爾
心系故	心繫故
米团	米糰
陋著稱	陋著稱
火并非	火並非
汤卤	汤滷
约占	約佔
云然	云然
，并力讨	，并力討
彩牌楼	綵牌樓
絷	縶
手松	手鬆
干爹	乾爹
于爾岑	于爾岑
䲣	䱷
䲢	鰧
干爽	乾爽
佳里鎮	佳里鎮
待著錄	待著錄
秀发动	秀發動
胎发	胎髮
備著錄	備著錄
塞拉耶佛	薩拉熱窩
臧谷亡羊	臧穀亡羊
几杖	几杖
女丑	女丑
含著作	含著作
会干扰	會干擾
冲线	衝線
戴表元	戴表元
庆历史	慶歷史
已占	已佔
忙著	忙着
闺范	閨範
个中高手	箇中高手
泪如泉涌	淚如泉湧
擋著	擋着
开发	開發
夜游	夜遊
年鉴	年鑑
垱	壋
稳扎	穩紮
響著述	響著述
盛著名	盛著名
丑地	醜地
龙斗虎伤	龍鬥虎傷
杰倫	杰倫
划了一會	划了一會
漫著	漫着
因特网	互聯網
一划	一划
划得来	划得來
躺著者	躺著者
凉面	涼麵
瞪著作	瞪著作
試著稱	試著稱
竹溪县	竹谿縣
佛罗棱萨	佛羅稜薩
借由	藉由
这只包括	這只包括
准保釋	准保釋
占至少	佔至少
重托	重託
溢著	溢着
骀荡	駘蕩
𦈠	䌥
𦈡	繻
科斗	科斗
奥黛丽·赫本	柯德莉·夏萍
𦈚	縬
𦈛	繓
𦈘	䌋
𦈙	䌰
𦈞	䌟
𦈟	䌝
𦈜	䌖
𦈝	繏
𦈒	𦂅
𦈓	䋿
𦈐	縺
頂著錄	頂著錄
𦈖	䌈
𦈗	𦃄
𦈔	縎
𦈕	緰
𦈋	綇
𦈈	𥿊
𦈉	緷
𦈎	繟
𦈏	緍
𦈌	綀
雨蒙蒙	雨濛濛
阵	陣
遇著名	遇著名
冒著書	冒著書
腾冲	騰衝
信著者	信著者
谳	讞
面坯儿	麵坯兒
宝历史	寶歷史
于友澤	于友澤
陶制	陶製
阎	閻
扎成	紮成
載著述	載著述
配著者	配著者
愿而恭	愿而恭
愛著名	愛著名
劃著	劃着
系上，	繫上，
睡著作	睡著作
懿范	懿範
并发症	併發症
阀	閥
划动	划動
蒙骗	矇騙
满头洋发	滿頭洋髮
巧历史	巧歷史
阆	閬
蓬松	蓬鬆
阇	闍
头发	頭髮
阄	鬮
赏赞	賞讚
西游	西遊
不托	不託
躯干	軀幹
疑著述	疑著述
空著者	空著者
𣗋	欓
四分历	四分曆
玮	瑋
石钟	石鐘
揮著	揮着
队	隊
苋	莧
苈	藶
苎	苧
苏	蘇
苌	萇
苍	蒼
苁	蓯
苇	葦
殺著錄	殺著錄
疑著稱	疑著稱
响钟	響鐘
半只	半隻
春游	春遊
占美國	佔美國
于承惠	于承惠
𪎌	麳
采药	採藥
于斯達爾	于斯達爾
𪎍	𪋿
挌斗	挌鬥
苧	薴
流著稱	流著稱
愠	慍
飏	颺
风	風
愦	憒
歹斗	歹鬥
布雷舰	佈雷艦
布置	佈置
一干弟子	一干弟子
飚	飈
飙	飆
飘	飄
變著名	變著名
飓	颶
飒	颯
飑	颮
飐	颭
飗	飀
飖	颻
飕	颼
飔	颸
喧哗	喧譁
飨	饗
回肠荡气	迴腸盪氣
衣著作	衣著作
著墨	着墨
喧哄	喧鬨
干红葡萄酒	乾紅葡萄酒
余温	餘溫
南回线	南迴線
缩栗	縮慄
夸嘴	誇嘴
占著名	佔著名
小周后	小周后
心系麦	心繫麥
里间	裡間
裝著書	裝著書
架钟	架鐘
流著	流着
只身心	只身心
負著	負着
文思泉涌	文思泉湧
魂牵梦系	魂牽夢繫
结伙	結夥
哥特式	哥德式
制纸	製紙
得著稱	得著稱
嚷著名	嚷著名
谩	謾
空蒙	空濛
心系他	心繫他
空气质量	空氣質素
航海历	航海曆
械斗	械鬥
水里商工	水里商工
一争两丑	一爭兩醜
警报钟	警報鐘
并购	併購
封面里	封面裡
烤卤	烤滷
采摘	採摘
干渠	乾渠
沉著述	沉著述
泳气钟	泳氣鐘
垂发	垂髮
隔著	隔着
占下风	佔下風
旧钟表	舊鐘錶
配著稱	配著稱
佛钟	佛鐘
框里	框裡
干渴	乾渴
嬷	嬤
唱著者	唱著者
大历	大曆
炼制	煉製
展著名	展著名
盈余	盈餘
獲著錄	獲著錄
8余	8餘
税	稅
跑著述	跑著述
當著錄	當著錄
稳	穩
𩟿	𩚛
蕭士塔高維奇	蕭士達高維契
丑男	醜男
𥇢	䁪
昔人有云	昔人有云
急著述	急著述
皮制	皮製
耀著名	耀著名
䢀	𨊰
掙著作	掙著作
繞著作	繞著作
反覆	反覆
叠	疊
系累	繫纍
号	號
叶	葉
涳蒙	涳濛
叹	嘆
绾发	綰髮
空著錄	空著錄
吉里巴斯	基里巴斯
揉著書	揉著書
参	參
叁	叄
干撂台	乾撂台
叇	靆
叆	靉
赞誉	讚譽
面包容	面包容
放松	放鬆
郁沉沉	鬱沉沉
复习	複習
双	雙
宝莱坞	波里活
叙	敘
变	變
背著述	背著述
呆里呆气	呆裡呆氣
船钟	船鐘
丑女效颦	醜女效顰
肚里	肚裡
淀淀	澱澱
严云农	嚴云農
䯃	𩣑
回纹针	迴紋針
䯄	騧
䯅	䯀
保障著稱	保障著稱
同伙	同夥
特制	特製
吞占	吞佔
珲	琿
天后天	天後天
附著述	附著述
〇余	〇餘
苦著作	苦著作
珑	瓏
珐	琺
郁抑	鬱抑
伊尔汗历表	伊爾汗曆表
万象	萬象
仑	侖
滚	滾
余式	餘式
全干	全乾
找得著	找得着
集数里	集數裡
削发	削髮
显示表达	顯示表達
曲櫱	麴櫱
暗著名	暗著名
余弦	餘弦
斗技	鬥技
7周后	7周後
复利	複利
于晴	于晴
复制	複製
哈啰喂	哈囉喂
鉴湖	鑑湖
行著作	行著作
莜面	莜麵
厘订	釐訂
会干	會幹
咸海	鹹海
心里	心裡
于飛	于飛
栖	棲
净余	淨餘
斗批改	鬥批改
么小	么小
声母后	聲母後
元凶	元兇
特制定	特制定
夸辩	誇辯
丑年	丑年
赵治勋	趙治勳
蟻后	蟻后
做著錄	做著錄
舒马赫	舒麥加
田庄英雄	田庄英雄
板球	木球
换	換
罗马历代	羅馬歷代
收获	收穫
夸奖	誇獎
𡶴	嵼
并入	併入
钟不	鐘不
钟上	鐘上
站著書	站著書
臨著名	臨著名
溢著錄	溢著錄
托言	託言
抓著者	抓著者
一余	一餘
日志	日誌
面包括	面包括
简并	簡併
布莱尔	貝理雅
芯片	晶片
凄然	悽然
奈洛比	內羅畢
吃里扒外	吃裡扒外
体系	體系
美发业	美髮業
国历	國曆
佣仆	傭僕
空氣品質	空氣質素
〇只	〇隻
舍己为人	捨己為人
釀著書	釀著書
不著邊際	不着邊際
项链	項鍊
說著作	說著作
本征	本徵
捡	撿
整出剧	整齣劇
范例	範例
是发小	是髮小
發著作	發著作
范登堡	范登堡
钟鸣	鐘鳴
晶体管	電晶體
自制	自製
遇著述	遇著述
冲击	衝擊
借著名	借著名
阳历	陽曆
走著作	走著作
分佈著	分佈着
立著《	立著《
𩖗	䫴
金钟	金鐘
挽联	輓聯
脊梁	脊樑
馍	饃
提著述	提著述
布雷速度	佈雷速度
西西里	西西里
窗明几净	窗明几淨
简筑翎	簡筑翎
𫁡	鴗
殺著述	殺著述
钟表快	鐘錶快
蘸著者	蘸著者
谷贵饿农	穀貴餓農
国仇	國讎
伊府面	伊府麵
郁郁而终	鬱鬱而終
满	滿
愛著述	愛著述
開山辟谷	開山辟谷
太仆	太僕
面制品	麵製品
蹦床	彈床
冰淇淋	雪糕
厮斗	廝鬥
准绳	準繩
苹婆	蘋婆
站著稱	站著稱
七个	七個
逆著述	逆著述
試著書	試著書
于會泳	于會泳
杠梁	杠梁
威爾士	威爾斯
鼗	鞀
夾著書	夾著書
連著錄	連著錄
枕著作	枕著作
于伟国	于偉國
苏崑	蘇崑
代数里	代數裡
縱著	縱着
祭吊	祭弔
颊须	頰鬚
瞪著錄	瞪著錄
参数里	參數裡
那只限	那只限
算准	算準
发簪	髮簪
橹	櫓
橼	櫞
𪎊	麨
薛丁格	薛定諤
干略	幹略
道范	道範
橥	櫫
布于	佈於
荝	萴
荞	蕎
荟	薈
心系非	心繫非
回翔	迴翔
荛	蕘
这出人	這出人
荐	薦
逼并	逼併
松劲	鬆勁
伴著稱	伴著稱
松动	鬆動
争斗	爭鬥
荆	荊
吧台	吧檯
复分数	複分數
巡回医疗	巡回醫療
據著稱	據著稱
張樂于張徐	張樂于張徐
挂名	掛名
荬	蕒
荭	葒
荮	葤
受著	受着
荨	蕁
荩	藎
荪	蓀
田里穗	田里穗
荤	葷
荥	滎
用著名	用著名
荧	熒
荠	薺
荡	盪
𩬤	𩰀
肉面	肉麵
天文钟	天文鐘
于湘蘭	于湘蘭
站著	站着
斥著	斥着
棱柱	稜柱
于斯納爾斯貝里	于斯納爾斯貝里
纸扎	紙紮
尽先	儘先
著火	着火
候著	候着
簸荡	簸蕩
6字节	6位元組
鱼松	魚鬆
當著述	當著述
想著者	想著者
獲著述	獲著述
旷	曠
后母戊	后母戊
心系贫	心繫貧
皇极历	皇極曆
咝	噝
吹著書	吹著書
猜著錄	猜著錄
涼著名	涼著名
跪著名	跪著名
咛	嚀
晒干	曬乾
舍去	捨去
征状	徵狀
8字节	8位元組
星羅棋布	星羅棋佈
備著作	備著作
燒著作	燒著作
铜钟	銅鐘
分多钟	分多鐘
余杭	餘杭
䌶	䊷
余杯	餘杯
龜山庄	龜山庄
表速	錶速
䌹	絅
干脆面	乾脆麵
䌿	䋹
䌾	䋻
䌽	綵
䌼	綐
炼字	鍊字
折梯	摺梯
心系曼	心繫曼
椰枣干	椰棗乾
占次	佔次
锤炼	錘鍊
细致	細緻
干甚么	幹甚麼
多只是	多只是
晃著述	晃著述
欲念	慾念
隐占	隱佔
希拉蕊	希拉莉
人物志	人物誌
香山庄	香山庄
洒然	洒然
媪	媼
冒著	冒着
学	學
里海	裏海
餐台	餐檯
向著書	向著書
于天仁	于天仁
划不来	划不來
受雇	受僱
窜	竄
酒坛	酒罈
數位電視	數碼電視
毁钟为铎	毀鐘為鐸
飄著稱	飄著稱
黏著	黏着
余量	餘量
窎	窵
𥅘	𥌃
窍	竅
綁著錄	綁著錄
中签了	中簽了
沈大铁路	瀋大鐵路
獲著書	獲著書
窃	竊
风干	風乾
窝里斗	窩裡鬥
骢	驄
窭	窶
考著作	考著作
左冲右突	左衝右突
窦	竇
窥	窺
雇员	僱員
渴著者	渴著者
吃板刀面	吃板刀麵
多天后	多天後
彭于晏	彭于晏
时钟	時鐘
摟著錄	摟著錄
旁征博引	旁徵博引
介胄	介冑
望著名	望著名
征庸	徵庸
圍著錄	圍著錄
潤著稱	潤著稱
領著者	領著者
考著錄	考著錄
于都縣	于都縣
有征	有徵
表里一致	表裏一致
干细胞	幹細胞
高著名	高著名
許愿起經	許愿起經
干衣	乾衣
刻著者	刻著者
抗御	抗禦
挤	擠
系上安全	繫上安全
占九	佔九
骒	騍
划走	划走
忍著稱	忍著稱
斗劲	鬥勁
划起	划起
于慧	于慧
于幼軍	于幼軍
怎么干	怎麼幹
乡愿	鄉愿
據著名	據著名
干鱼	乾魚
赞乐	讚樂
斗力	鬥力
汇丰	滙豐
吊脚儿事	弔腳兒事
骜	驁
轉著者	轉著者
霉黑	黴黑
8天后	8天後
布控	佈控
面包抄	面包抄
骟	騸
要占卜	要占卜
霉黧	黴黧
上签定	上簽定
卤的	滷的
帕劳	帛琉
鳩占	鳩佔
揪须	揪鬚
澄澹精致	澄澹精致
平准	平準
如果干	如果幹
三出戏	三齣戲
钟乳石	鐘乳石
變著者	變著者
麗著書	麗著書
鉴藏	鑑藏
余酲	餘酲
垦辟	墾闢
参绥	蔘綏
毛里求斯	毛里裘斯
百子里	百子里
面团	麵團
姜丝	薑絲
豆干	豆乾
徒杠	徒杠
戴著名	戴著名
䴖	鶄
另辟	另闢
萦回	縈迴
的干将	的幹將
发漂	髮漂
面摊	麵攤
骏	駿
四天后	四天後
抢	搶
抡	掄
抠	摳
0天后	0天後
钟行	鐘行
报	報
护	護
急冲而下	急衝而下
占頭籌	佔頭籌
余生	餘生
自制之能	自制之能
数只是	數只是
骨坛	骨罈
塞爾維亞與蒙特內哥羅	塞爾維亞和黑山
渊淳岳峙	淵淳嶽峙
口干涉	口干涉
表板	錶板
并发模式	併發模式
其八九只	其八九只
抛	拋
顼	頊
顿	頓
于若木	于若木
抟	摶
顸	頇
须	須
顺	順
看著述	看著述
顷	頃
顶	頂
拉面无	拉面無
干啥	幹啥
忙著書	忙著書
𩨍	𩥇
低著書	低著書
耕获	耕穫
采访	採訪
干啼	乾啼
持著	持着
征用	徵用
著數	着數
于凤桐	于鳳桐
才干	才幹
葡萄干	葡萄乾
击剑	劍擊
市占	市佔
擀面	擀麵
借助	藉助
钟表	鐘錶
甜著者	甜著者
心著者	心著者
乐器钟	樂器鐘
找不著	找不着
武后	武后
咸的	鹹的
蚊动牛斗	蚊動牛鬥
狂占	狂佔
韫	韞
味著名	味著名
韪	韙
沣	灃
顽	頑
没	沒
沧	滄
沦	淪
跳著述	跳著述
蒙著述	蒙著述
沪	滬
沩	溈
沨	渢
游兴	遊興
冲克	衝剋
五个	五個
顾	顧
大型钟	大型鐘
藏历	藏曆
杆菌	桿菌
韦	韋
网里	網裡
示范	示範
𣽷	瀃
鋪著書	鋪著書
刻著錄	刻著錄
袅	裊
袄	襖
岳麓	嶽麓
袆	褘
鸩	鴆
采薇	採薇
朴素	樸素
页	頁
流著作	流著作
尽量	儘量
袭	襲
后土	后土
袯	襏
采薪	採薪
杨	楊
過著述	當著述
不只	不只
谷保家商	穀保家商
脏腑	臟腑
归余	歸餘
隔著作	隔著作
丁丑	丁丑
准保護	准保護
坑口里	坑口里
里脊	裡脊
卤	鹵
卧	臥
来	來
卢	盧
卫	衛
却	卻
酿制	釀製
偷著書	偷著書
丰韻	丰韻
嚷著者	嚷著者
大丑	大醜
丰韵	丰韻
戴著書	戴著書
咸淡	鹹淡
穿著者	穿著者
占人便宜	佔人便宜
华	華
云何	云何
一碗面	一碗麵
单	單
卖	賣
拉面	拉麵
雅著称	雅著稱
几面上	几面上
钟表面	鐘表面
于來山	于來山
獨占	獨佔
牵	牽
鋪著名	鋪著名
戴著稱	戴著稱
晃著者	晃著者
划龍舟	划龍舟
系紧	繫緊
牺	犧
厘革	釐革
牦	氂
飄著書	飄著書
炼冶	鍊冶
体范	體範
潜水表	潛水錶
為著述	為著述
划龍船	划龍船
洪钟	洪鐘
蒙鸿	濛鴻
冬冬鼓	鼕鼕鼓
幸幸	倖幸
牍	牘
淀北片	澱北片
皇历	皇曆
手塚治虫	手塚治虫
里衣	裡衣
吴	吳
多只限	多只限
接著作	接著作
启	啟
听	聽
强制	強制
吨	噸
過著稱	當著稱
吣	唚
崑腔	崑腔
模范棒棒堂	模范棒棒堂
吗	嗎
吕	呂
系船	繫船
吓	嚇
后	後
語著	語着
翕辟	翕闢
凶悍	兇悍
凶恶	兇惡
跳著書	跳著書
员	員
䎬	䎱
钟螺	鐘螺
松紧	鬆緊
出丑	出醜
籁	籟
辫发	辮髮
于赠	于贈
促著	促着
家仆	家僕
抓著	抓着
騙著者	騙著者
駕著	駕着
干田	乾田
順著作	順著作
潤著述	潤著述
天历	天曆
抽公签	抽公籤
占劣	佔劣
側著者	側著者
发鬓	髮鬢
类	類
心系晓	心繫曉
呓	囈
准三后	准三后
信著述	信著述
B肝	乙肝
躍著錄	躍著錄
候复	候覆
采录	採錄
开采	開採
鉴识	鑑識
涩谷区	澀谷區
捣鬼吊白	搗鬼弔白
冲程	衝程
凯瑟琳	嘉芙蓮
母丑	母醜
關著錄	關著錄
征令	徵令
盛著書	盛著書
干支剌	乾支剌
京沈	京瀋
扛著述	扛著述
划槳	划槳
里氏4	黎克特制4
里氏5	黎克特制5
里氏6	黎克特制6
里氏7	黎克特制7
努力著書	努力著書
里氏1	黎克特制1
里氏2	黎克特制2
里氏3	黎克特制3
瓮安	甕安
发状况	發狀況
里氏8	黎克特制8
里氏9	黎克特制9
求著者	求著者
寶山庄	寶山庄
胡渣	鬍渣
馕	饢
国历代	國歷代
扛大梁	扛大樑
这	這
停征	停徵
心系父	心繫父
计算机程序	電腦程式
賦范	賦范
溢著書	溢著書
于思	于思
朝著述	朝著述
府干犯	府干犯
盛著錄	盛著錄
駕著書	駕著書
東協議	東協議
于娜	于娜
閑著作	閑著作
側著	側着
干裂	乾裂
灰蒙	灰濛
未干预	未干預
个中玄机	箇中玄機
征引	徵引
因著書	因著書
闲邪	閑邪
只冲	只衝
不占卜	不占卜
占俄	佔俄
逞凶斗狠	逞兇鬥狠
咸菜	鹹菜
征调	徵調
凄美	悽美
剖厘	剖釐
游必有方	遊必有方
夾著稱	夾著稱
能干预	能干預
背著者	背著者
爭著	爭着
毕	畢
折痕	摺痕
划去	划去
毙	斃
錾	鏨
复色	複色
變著錄	變著錄
毁	毀
毂	轂
辛丑	辛丑
迹	跡
紐賓士域	紐賓士域
毵	毿
复眼	複眼
沟	溝
𩨈	騟
蓋著名	蓋著名
毡	氈
夸他	誇他
镰仓	鎌倉
豎著者	豎著者
遇著者	遇著者
吊撒	弔撒
宪法里	憲法裡
開著稱	開著稱
四杆铁笔	四桿鐵筆
于天龙	于天龍
制著作	制著作
余兴	餘興
余八	餘八
鉴往知来	鑑往知來
余六	餘六
備著稱	備著稱
于广洲	于廣洲
蝎谮	蝎譖
菸	煙
于天龍	于天龍
余党	餘黨
这出世	這出世
钟没	鐘沒
沥	瀝
䲞	𩶘
沤	漚
旅游	旅遊
半制品	半制品
遇著称	遇著稱
余光	餘光
几只	幾隻
隨著書	隨著書
范文藤	范文藤
蘸著述	蘸著述
森林里	森林裡
戯	戱
冲垮	衝垮
哗笑	譁笑
干哥	乾哥
痒疹	痒疹
干哭	乾哭
追著述	追著述
后面店	後面店
列支敦斯登	列支敦士登
馬利共和國	馬里共和國
复议	複議
干篾片	乾篾片
四面包	四面包
卤鹅	滷鵝
戏	戲
戋	戔
应钟	應鐘
戆	戇
看准	看準
战	戰
干柴烈火	乾柴烈火
干哕	乾噦
著妳	着妳
麗著稱	麗著稱
𨱏	鎝
𨱎	鍮
𨱍	鎯
𨱌	鏆
𨱋	錂
𨱊	𨧱
唱著書	唱著書
𨱈	鋉
𨱇	銶
散布著	散佈着
𨱅	鉁
𨱄	鈯
𨱃	鈲
𨱂	鈋
𨱁	鈠
𨱀	𨥛
扛著名	扛著名
賈伯斯	喬布斯
𨱖	䥩
多出电影	多齣電影
𨱔	鐏
𨱓	鐎
𨱒	鏉
雜著	雜着
𨱐	𨫒
𣶩	澅
准例	準例
𣶫	𣿉
住著述	住著述
注译	註譯
腌制	醃製
衬里	襯裡
海湾布雷	海灣佈雷
梁柱	樑柱
里边	裡邊
发廊	髮廊
密致	密緻
当准	當準
娆	嬈
娇	嬌
路签	路籤
娅	婭
仗著述	仗著述
冲陷	衝陷
蛰	蟄
代码表	代碼表
娴	嫻
拳局	拳跼
娱	娛
辟为	闢為
蒙瞍	矇瞍
无征不信	無徵不信
蛴	蠐
涼著	涼着
奸情	姦情
鼠曲草	鼠麴草
领袖欲	領袖慾
志异	誌異
电子钟	電子鐘
香干	香乾
淳朴	淳樸
占用	佔用
钟表王	鐘錶王
电	電
蛎	蠣
画	畫
𪨊	㞞
蜂准	蜂準
不嫌母丑	不嫌母醜
袜	襪
䓖	藭
亿个	億個
回复邮件	回覆郵件
冲要	衝要
持著述	持著述
专	專
很丑	很醜
伏地挺身	掌上壓
还占	還佔
伙头	伙頭
于克-兰多县	于克-蘭多縣
愛著作	愛著作
刮起来	刮起來
咸湖	鹹湖
關著作	關著作
台静农	臺靜農
移动电话	流動電話
多只须	多只須
勋	勛
门吊儿	門弔兒
盯著稱	盯著稱
撞阵冲军	撞陣衝軍
墙里	牆裡
咸湿	鹹濕
角抵	角牴
勚	勩
口干预	口干預
雜著作	雜著作
干糇	乾餱
5只支援	5只支援
狱	獄
狰	猙
狲	猻
尖峰時間	繁忙時間
风土志	風土誌
狭	狹
独	獨
狯	獪
狮	獅
婵	嬋
丑沮	醜沮
钟顶	鐘頂
洋河大曲	洋河大麯
疲困	疲睏
占線	佔線
大历史	大歷史
狞	獰
暗著作	暗著作
婶	嬸
松通	鬆通
金表面	金表面
刮了	颳了
狈	狽
数字照相机	数碼照相機
堑	塹
喜欢钟	喜歡鐘
干系	干係
戴发含齿	戴髮含齒
轉向	轉向
闻风后	聞風後
壮游	壯遊
鉴别	鑑別
斗斗	鬥鬥
干耗	乾耗
赤绳系足	赤繩繫足
數位照相機	数碼照相機
斗文	鬥文
冒著名	冒著名
頂著書	頂著書
解铃还须系铃人	解鈴還須繫鈴人
駕著述	駕著述
绞干	絞乾
占尽	佔盡
钟发音	鐘發音
僵尸	殭屍
心系病	心繫病
斗引	鬥引
借著作	借著作
掖著錄	掖著錄
回文联	迴文聯
额征	額徵
占少	佔少
沙里淘金	沙裡淘金
側著錄	側著錄
住扎	住紮
占小	佔小
斗地主	鬥地主
心系地	心繫地
拖著作	拖著作
几旁	几旁
暴敛横征	暴斂橫徵
修胡刀	修鬍刀
暗地里	暗地裡
宦游	宦遊
耀著者	耀著者
抬著名	抬著名
冲突	衝突
低著者	低著者
牵系	牽繫
鬥著作	鬥著作
哗噪	譁噪
陋著者	陋著者
痳疯	痳瘋
么九	么九
口干	口乾
只字	隻字
姜糖	薑糖
刻钟	刻鐘
鸡争鹅斗	雞爭鵝鬥
對著者	對著者
构	構
战栗	戰慄
喝著名	喝著名
昆腔	崑腔
鲸须	鯨鬚
于欣源	于欣源
湖里	湖裡
真凶	真兇
被发阳狂	被髮陽狂
繞著書	繞著書
只身体	只身體
月历	月曆
努力著者	努力著者
霉素	黴素
氇	氌
那只有	那只有
邬	鄔
获	獲
邮	郵
监制	監製
5字节	5位元組
邺	鄴
邻	鄰
恶斗	惡鬥
子之丰兮	子之丰兮
領著稱	領著稱
场里	場裡
布里斯托尔	布里斯托
猜著者	猜著者
只身旁	只身旁
氢	氫
金仆姑	金僕姑
刻著稱	刻著稱
氩	氬
则	則
莼	蓴
不食乾腊	不食乾腊
游民	遊民
邝	鄺
氲	氳
佳肴	佳肴
七只	七隻
𢭏	擣
邓	鄧
白发	白髮
眍	瞘
余荫	餘蔭
吊膀子	弔膀子
黑奴吁天录	黑奴籲天錄
騎著書	騎著書
褛	褸
奇勋	奇勳
見著	見着
拿著者	拿著者
靠著者	靠著者
干礼	乾禮
闹表	鬧錶
霉菌	黴菌
干生受	乾生受
代表著稱	代表著稱
采用	採用
吊扣	弔扣
不占	不佔
火箭布雷	火箭佈雷
埃及历	埃及曆
苦著者	苦著者
不卷	不捲
协	協
墨沈	墨瀋
细不容发	細不容髮
息交绝游	息交絕遊
𣍰	脥
著地	着地
八扎	八紮
𣍨	𦢈
腰里	腰裡
光著称	光著稱
于子千	于子千
𣍯	腪
于韦斯屈莱	于韋斯屈萊
當著	當着
歼	殲
复苏	復甦
麦	麥
小几	小几
发笺	髮箋
于家堡	于家堡
于道泉	于道泉
中文里	中文裡
哭著作	哭著作
麸	麩
麹	麴
逼著稱	逼著稱
聩	聵
聪	聰
余1	餘1
这出生	這出生
余6	餘6
千个	千個
准决赛	準決賽
見著述	見著述
因著稱	因著稱
據著述	據著述
醜著名	醜著名
余5	餘5
叱吒	叱咤
聋	聾
职	職
聍	聹
从山里	從山裡
聂	聶
仆程	僕程
政斗	政鬥
睡著書	睡著書
6只支持	6只支持
釀著者	釀著者
挑著作	挑著作
釀著	釀着
联	聯
陈杰	陳杰
淀谓之滓	澱謂之滓
万周后	萬周後
中签发	中簽發
昙	曇
飄著	飄着
拓朴	拓樸
批斗	批鬥
对华发	對華發
照入签	照入籤
蕴	蘊
挑著錄	挑著錄
鼓里	鼓裡
面包庇	面包庇
響著	響着
還占	還佔
回肠	迴腸
轮回	輪迴
冰激凌	雪糕
冲车	衝車
览	覽
糁	糝
几净窗明	几淨窗明
空著作	空著作
糇	餱
印著書	印著書
饥馑	饑饉
，并力討	，并力討
斗眼	鬥眼
凶相毕露	凶相畢露
心系彼	心繫彼
模范	模範
伊東怜	伊東怜
風采	風采
干疥	乾疥
人云	人云
余子明	余子明
趴著書	趴著書
蒜发	蒜髮
披著	披着
妈	媽
网球台	網球台
系着	繫着
妆	妝
響著者	響著者
数只会	數只會
发干	發乾
皮松	皮鬆
傲游	傲遊
太初历史	太初歷史
妩	嫵
妪	嫗
妫	媯
颠颠仆仆	顛顛仆仆
婢仆	婢僕
心繫农	心繫农
冲量	衝量
差之毫厘	差之毫厘
吊影	弔影
疮	瘡
疯	瘋
疬	癧
疭	瘲
疠	癘
疡	瘍
鬥著錄	鬥著錄
采择	採擇
心系众	心繫眾
心系港	心繫港
疱	皰
闲荡	閒蕩
爭著作	爭著作
重复	重複
向著稱	向著稱
纪历史	紀歷史
荡妇	蕩婦
银发	銀髮
猜著	猜着
福馬林	福爾馬林
胡子婴	胡子嬰
疖	癤
疗	療
斗牙拌齿	鬥牙拌齒
照占	照佔
脱发	脫髮
贵干	貴幹
衅钟	釁鐘
鳥栖市	鳥栖市
金表扬	金表揚
威尔士	威爾斯
采在	採在
于凌奎	于凌奎
由表及里	由表及裏
征得	徵得
燒著	燒着
农民历史	農民歷史
鸡吵鹅斗	雞吵鵝鬥
渴著作	渴著作
想著称	想著稱
𠆲	儣
回旋加速	回旋加速
划過	划過
余论	餘論
𠆿	𠌥
义仆	義僕
并日而食	并日而食
数字电视	數碼電視
腾格里	騰格里
醜著稱	醜著稱
占住	佔住
占位	佔位
未干預	未干預
㧰	擽
急著書	急著書
牙签	牙籤
盗钟	盜鐘
㧏	掆
捏面人	捏麵人
大型钟表	大型鐘錶
隨著稱	隨著稱
趴著名	趴著名
零个	零個
㧟	擓
㧑	撝
㧐	㩳
电冲	電衝
月里来	月裡來
拿著名	拿著名
挨著錄	挨著錄
靠著名	靠著名
𡝠	㜷
夾著作	夾著作
塞耳盗钟	塞耳盜鐘
干股	乾股
阃范	閫範
面包涵	面包涵
干肥	乾肥
雇车	僱車
尽早	儘早
于小惠	于小惠
回复中	回覆中
借手	藉手
澄江县	澂江縣
𩠆	𩜦
罵著述	罵著述
于洪區	于洪區
余墨	餘墨
席哈克	希拉克
乙丑	乙丑
炼汞	鍊汞
系舟	繫舟
只身份	只身份
跹	躚
走著者	走著者
棱台	稜台
于爾里克	于爾里克
没样范	沒樣範
太凶	太兇
有恒街	有恒街
于敏中	于敏中
晃著名	晃著名
结发	結髮
张柏芝	張栢芝
钟形虫	鐘形蟲
領著述	領著述
朴陋	樸陋
光著述	光著述
准时	準時
西臺文	赫梯文
勋业	勳業
回复：	回覆：
掷	擲
掴	摑
掳	擄
演著述	演著述
掼	摜
私斗	私鬥
掺	摻
掸	撣
壳里	殼裡
強制	強制
饹	餎
饸	餄
饻	餏
饺	餃
饽	餑
饼	餅
饿	餓
饾	餖
饱	飽
饰	飾
饳	飿
饲	飼
饵	餌
饴	飴
饷	餉
寫著	寫着
松浮	鬆浮
饨	飩
饫	飫
衣著稱	衣著稱
饭	飯
饬	飭
饯	餞
饮	飲
干呕	乾嘔
饣	飠
丛林里	叢林裡
饥	飢
一目了然	一目了然
饧	餳
饦	飥
䲠	鰆
蹑	躡
蹒	蹣
涂序瑄	涂序瑄
柳诒征	柳詒徵
吊者大悦	弔者大悅
颳著	颳着
沿著書	沿著書
䴙	鷿
准会	準會
蹰	躕
勋章	勳章
䴘	鷈
采区	採區
蹿	躥
逻	邏
站著作	站著作
党項	党項
后里	后里
涟	漣
桢	楨
涝	澇
麗著者	麗著者
电影后	電影後
拖著錄	拖著錄
打拼	打拚
𢫬	摋
递	遞
桡	橈
屏风后	屏風後
涩	澀
涨	漲
涧	澗
桦	樺
深山里	深山裡
涤	滌
涣	渙
涢	溳
涡	渦
涠	潿
适	適
乱发	亂髮
䴕	鴷
逊	遜
𢫊	𢷮
桥	橋
忙著名	忙著名
于漢超	于漢超
不采聲	不采聲
松一口气	鬆一口氣
心著錄	心著錄
開著書	開著書
不萊梅	不來梅
蝎蝎螫螫	蝎蝎螫螫
诗赞	詩讚
于枫	于楓
膠著述	膠著述
尽是	儘是
學著作	學著作
𨐉	𨎮
𨐊	𨏥
𨐅	軗
𨐆	𨊻
𨐇	𨏠
拖著述	拖著述
往日无仇	往日無讎
余蓄	餘蓄
趙惠后	趙惠后
出游	出遊
吊拷	弔拷
十出生	十出生
剩余	剩餘
福著作	福著作
苑裡	苑裡
没干没净	沒乾沒淨
載著名	載著名
干柴	乾柴
剥	剝
于克-蘭多縣	于克-蘭多縣
剧	劇
漫著書	漫著書
局里	局裡
剑	劍
剐	剮
尸羅精舍	尸羅精舍
剀	剴
急著名	急著名
剂	劑
拉面上	拉面上
云為	云為
复信	覆信
云乎	云乎
航天飞机	穿梭機
湮郁	湮鬱
南游	南遊
轉著作	轉著作
借机	藉機
待著名	待著名
国历史	國歷史
吕后	呂后
悠悠荡荡	悠悠蕩蕩
䥺	釾
中岳	中嶽
䥾	䥱
䥿	𨯅
钟左右	鐘左右
采石之战	采石之戰
吞并	吞併
广播里	廣播裡
于風政	于風政
達著錄	達著錄
追著稱	追著稱
于国治	于國治
心系嘱	心繫囑
胡云	胡云
进两出	進兩出
四出征收	四出徵收
碑志	碑誌
夾著錄	夾著錄
留著者	留著者
一半只	一半只
多余	多餘
后髮座	后髮座
保障著述	保障著述
扎带子	紮帶子
卷地	捲地
这只在	這只在
9天后	9天後
只言片语	隻言片語
漫著述	漫著述
于冠華	于冠華
揮手表	揮手表
网	網
历局	曆局
罗	羅
果干	果乾
折椅	摺椅
罂	罌
沿著	沿着
上签订	上簽訂
迦納	加納
们干的	們幹的
缓冲	緩衝
罴	羆
流露著	流露着
冲过	衝過
戀著述	戀著述
罢	罷
澒蒙	澒濛
跄	蹌
筑前	筑前
叫著錄	叫著錄
坐著名	坐著名
代表著	代表着
鳘	鰵
郁结	鬱結
几周后	幾周後
鳞	鱗
木钟	木鐘
釀著名	釀著名
准儿	準兒
台风	颱風
鳓	鰳
籼	秈
和奸	和姦
身著名	身著名
复次	複次
制得	製得
反反复复	反反覆覆
血余	血餘
烘制	烘製
會占卜	會占卜
千周后	千周後
菜肴	菜餚
鳕	鱈
上面糊	上面糊
反朴	反樸
钵	缽
配合著名	配合著名
照著書	照著書
帕塔亚	芭達亞
打风后	打風後
遇风后	遇風後
朴鄙	樸鄙
昆剧	崑劇
薝卜	薝蔔
甩发	甩髮
高著書	高著書
〇周后	〇周後
王田里	王田里
钩心斗角	鈎心鬥角
鳏	鰥
麻酱面	麻醬麵
進占	進佔
皺著名	皺著名
鳎	鰨
游走	遊走
坦荡	坦蕩
瘘	瘺
凶杀	兇殺
炼师	鍊師
丰台	豐臺
堡子里	堡子里
尋著書	尋著書
連著述	連著述
含齿戴发	含齒戴髮
局躅	跼躅
得著者	得著者
騙著書	騙著書
鳆	鰒
鉴证	鑑證
游资	遊資
肉丝面	肉絲麵
當著名	當著名
火山里	火山裡
余割	餘割
低著述	低著述
待著述	待著述
征购	徵購
蓋著	蓋着
踏著作	踏著作
于根伟	于根偉
攒	攢
向著述	向著述
莱特湾	雷伊泰灣
饭后钟	飯後鐘
梦里	夢裡
斗倒	鬥倒
划进	划進
溲面	溲麵
钟关	鐘關
郁黑	鬱黑
详注	詳註
兆个	兆個
悠著述	悠著述
划过	划過
空投布雷	空投佈雷
谷皮	穀皮
太阁	太閤
分布著	分佈着
棱镜	稜鏡
驶	駛
啰啰苏苏	囉囉囌囌
鸟	鳥
麗著作	麗著作
党進	党進
二缶钟惑	二缶鐘惑
浮著	浮着
鸪	鴣
鸫	鶇
鸨	鴇
他干的	他幹的
鸮	鴞
鸯	鴦
云：	云：
鸭	鴨
鸢	鳶
鸣	鳴
嚷著作	嚷著作
鸡	雞
鸦	鴉
鸧	鶬
鸤	鳲
鸥	鷗
鸺	鵂
鸻	鴴
鸸	鴯
鸹	鴰
鸾	鸞
十余	十餘
鸼	鵃
驼	駝
鸲	鴝
鸳	鴛
鸰	鴒
鸱	鴟
鸶	鷥
鸷	鷙
鸴	鷽
鸵	鴕
因著錄	因著錄
驾	駕
胶	膠
’s	’s
皺著錄	皺著錄
竹林之游	竹林之遊
争红斗紫	爭紅鬥紫
防制法	防制法
點著錄	點著錄
大批涌到	大批湧到
雇佣	僱傭
子里甲	子里甲
朝著	朝着
胧	朧
五行生克	五行生剋
胫	脛
胨	腖
驺	騶
吊文	弔文
美丑	美醜
清心寡欲	清心寡欲
壓著書	壓著書
胶卷	膠捲
单单于	單單於
胜	勝
胀	脹
胁	脅
胆	膽
邋里邋遢	邋裡邋遢
表快	錶快
干号	乾號
雠	讎
干台	乾颱
冒著述	冒著述
雳	靂
松蛋	鬆蛋
仗著名	仗著名
挠	撓
挣	掙
挢	撟
挥	揮
驯	馴
挦	撏
台风奖	台風獎
挛	攣
挚	摯
挝	撾
挜	掗
占有五不	占有五不
挞	撻
胡朴安	胡樸安
唱著	唱着
雏	雛
遇著錄	遇著錄
碛	磧
编钟	編鐘
心著述	心著述
徒托空言	徒託空言
赫魯雪夫	赫魯曉夫
余气	餘氣
挂	掛
帶著作	帶著作
心系澳	心繫澳
赞许	讚許
浮夸	浮誇
麗著名	麗著名
四面钟	四面鐘
于偉國	于偉國
试制	試製
朴直	樸直
鋪著	鋪着
卷走	捲走
涼著錄	涼著錄
卷起	捲起
刚雇	剛僱
想著書	想著書
应用程序	應用程式
𨤰	𨤻
笑著者	笑著者
交游	交遊
夾著名	夾著名
中风后	中風後
義大利	意大利
卤水	滷水
干急	乾急
行動電話	流動電話
忙著述	忙著述
千回百折	千迴百折
余思敏	余思敏
聞著	闻着
披著者	披著者
望著	望着
磁制	磁製
头	頭
相克	相剋
夺	奪
波发藻	波髮藻
夹	夾
鬧著	鬧着
备	備
处	處
滃郁	滃鬱
中签定	中簽定
个钟表	個鐘錶
复	復
脊梁骨	脊梁骨
局促不安	局促不安
擺著述	擺著述
卧游	臥遊
够	夠
桌游	桌遊
八字胡	八字鬍
吹著稱	吹著稱
琼	瓊
手表明	手表明
卤肉	滷肉
禾谷	禾穀
拧	擰
琎	璡
琏	璉
乘著称	乘著稱
苦干	苦幹
干打雷	乾打雷
那只比	那只比
喂了一声	喂了一聲
琐	瑣
击	擊
曲尘	麴塵
零只	零隻
7天后	7天後
凿	鑿
丑毙了	醜斃了
看法里	看法裡
创获	創穫
奸淫	姦淫
塞維亞	西維爾
占著述	占著述
凫	鳧
干杯	乾杯
凭	憑
警世钟	警世鐘
几	幾
汉弥登钟	漢彌登鐘
凤	鳳
凛	凜
后冠	后冠
马自达	萬事得
凑	湊
干材	乾材
这出乎	這出乎
哭著書	哭著書
穷发	窮髮
凉	涼
踯	躑
减	減
百余	百餘
净	淨
摟著	摟着
凄	淒
纡余	紆餘
斲雕为朴	斲雕為樸
斥著錄	斥著錄
爱困	愛睏
流著錄	流著錄
于尔根	于爾根
馂余	餕餘
躺著	躺着
殺著名	殺著名
𪉑	鷔
𪉐	𪃍
𪉓	𪈼
𪉒	𪄕
𪉕	𪇳
𪉔	𪄆
波棱菜	波稜菜
仅余	僅餘
械系	械繫
缠斗	纏鬥
𪉃	鳼
𪉂	䲰
𪉅	𪀦
𪉄	𩿪
𪉆	鴲
皺著稱	皺著稱
𪉈	鴜
𪉋	𪀾
𪉊	鷨
𪉍	鵚
可鉴	可鑑
𪉏	𪃏
𪉎	𪂆
人干的	人幹的
卷款	捲款
多丑	多醜
攻占	攻佔
紮著	紮着
多只可	多只可
馆谷	館穀
纲鉴	綱鑑
余外	餘外
复变函数	複變函數
复合	複合
逼著名	逼著名
发网菌	髮網菌
菠萝干	菠蘿乾
含著	含着
舒卷	舒捲
百周后	百周後
百只足夠	百只足夠
于遠偉	于遠偉
游荡	遊蕩
筑州	筑州
唾面自干	唾面自乾
托了	託了
嘯吒	嘯咤
托事	託事
干脆	乾脆
咸菜干	鹹菜乾
沈山线	瀋山線
拟	擬
𧮪	詀
发为血之本	髮為血之本
涂壮勋	涂壯勳
望了望	望了望
回响	迴響
干肉片	乾肉片
西洋棋	國際象棋
燒著書	燒著書
荡气回肠	盪氣迴腸
累囚	纍囚
咪表	咪錶
辟谷	辟穀
余光中	余光中
进占	進佔
杰威爾	杰威爾
捆著名	捆著名
撼著者	撼著者
裝著錄	裝著錄
霄裡	霄裡
林鹅峰	林鵞峰
游记	遊記
爱	愛
水里	水裡
6周后	6周後
披榛采兰	披榛採蘭
厮	廝
特别致	特别致
舊庄	舊庄
獲著	獲着
面茶	麵茶
當著稱	當著稱
于再清	于再清
提著名	提著名
力争上游	力爭上遊
征怪	徵怪
塞维利亚	西維爾
钓	釣
海灣布雷	海灣佈雷
言大而夸	言大而夸
𩧦	𩡺
謝華后	謝華后
并为一家	併為一家
留著錄	留著錄
逆著名	逆著名
伊斯兰历史	伊斯蘭歷史
组里	組裡
镉	鎘
洒	灑
于尔岑	于爾岑
黏著作	黏著作
嘉谷	嘉穀
殺著書	殺著書
于娟	于娟
拼著	拼着
镍	鎳
醯	酰
只身體	只身體
带发修行	帶髮修行
0字节	0位元組
长历史	長歷史
困著稱	困著稱
谷谷	穀穀
洼	窪
映著名	映著名
陳士杰	陳士杰
回文锦	迴文錦
喝著述	喝著述
存在著	存在着
安沈铁路	安瀋鐵路
殺著稱	殺著稱
下签发	下簽發
丑行	醜行
智財權	知識產權
大型钟表面	大型鐘表面
复选	複選
宽松	寬鬆
格里历	格里曆
9余	9餘
𩾋	䱰
𩾊	䱬
𩾈	䱙
低著	低着
官历	官曆
𩾌	鱇
來著述	來著述
巡游	巡遊
待著者	待著者
𩾇	鯱
𩾆	𩸦
逼著述	逼著述
𩾄	𩷰
龌	齷
马恩岛	萌島
龈	齦
龉	齬
龊	齪
龋	齲
龄	齡
龅	齙
龆	齠
龇	齜
龀	齔
龁	齕
龂	齗
龃	齟
镑	鎊
龟	龜
龙	龍
龚	龔
帶著	帶着
制毒	製毒
笑著作	笑著作
沈淀	沈澱
摈	擯
海淀山后	海淀山後
摆	擺
摇	搖
摄	攝
摅	攄
赶面棍	趕麵棍
纏著名	纏著名
持著稱	持著稱
荡气	蕩氣
镩	鑹
重回	重回
布點	佈點
逆著錄	逆著錄
腼	靦
腽	膃
腾	騰
恒生	恒生
于根偉	于根偉
腻	膩
欲海难填	欲海難填
哥廷根	格丁根
露丑	露醜
與著述	與著述
下签订	下簽訂
腭	齶
心系长	心繫長
發著	發着
志喜	誌喜
扎实	紮實
陳冲	陳冲
凭借	憑藉
腌	醃
印累绶若	印纍綬若
镣	鐐
腊	臘
托故	託故
腊笔	腊筆
心脏	心臟
岱岳	岱嶽
伙同	夥同
八个	八個
詟	讋
𤶧	𤸫
典范	典範
8周后	8周後
祝赞	祝讚
梁启超	梁啓超
之征	之徵
翙	翽
翘	翹
翚	翬
𢬦	𢹿
联系	聯繫
一出好戏	一齣好戲
心系广	心繫廣
隨著作	隨著作
摟著名	摟著名
髭胡	髭鬍
吊头	弔頭
修杰麟	修杰麟
镵	鑱
䶮	龑
敞著	敞着
贤	賢
·范	·范
素面	素麵
钟停	鐘停
䥽	鏺
鋪著作	鋪著作
𩾎	𩽇
蘊涵著	蘊涵着
杠人	杠人
里层	裡層
樂著稱	樂著稱
里屋	裡屋
虚夸	虛誇
蒙事	矇事
辦著書	辦著書
数字技术	數碼技術
五岳	五嶽
慌里慌张	慌裡慌張
征答	徵答
耀著作	耀著作
不占算	不占算
浕	濜
墙	牆
巴貝多	巴巴多斯
藏历史	藏歷史
𪢮	圞
占有	佔有
不好干涉	不好干涉
廍子里	廍子里
靠著作	靠著作
當著者	當著者
筑阳	筑陽
7只支援	7只支援
天后来	天後來
扼肮	搤肮
表蒙子	錶蒙子
穿著	穿着
年里约	年里約
占率	佔率
捆著錄	捆著錄
年历史	年歷史
璎	瓔
劉佳怜	劉佳怜
喝著者	喝著者
𩾂	䲖
于风政	于風政
將占	將佔
馬斯垂克	馬斯特里赫特
月历史	月歷史
，并力	，並力
余勇	餘勇
种师道	种師道
叩钟	叩鐘
麗著	麗着
府干擾	府干擾
空著名	空著名
𩙰	𩙈
余貾	餘貾
浓发	濃髮
心系在	心繫在
刮起	颳起
刮走	颳走
答复	答覆
安地卡及巴布達	安提瓜和巴布達
𩙦	𩗀
𩙧	𩗡
𩙥	颰
𩙪	颷
𩙫	颾
𩙨	𩘹
丰南	丰南
𩙮	䬘
𩙯	䬝
𩙬	𩘺
𩙭	𩘝
柯林頓	克林頓
台风后	颱風後
千钧一发	千鈞一髮
花哄	花鬨
面包管	面包管
丑媳	醜媳
植发	植髮
仆役	僕役
郑	鄭
應著述	應著述
篮板球	籃板球
西占	西佔
复元音	複元音
好斗室	好斗室
㻘	𤪺
溟蒙	溟濛
拖著	拖着
㻏	𤫩
馏	餾
复核	覆核
往里	往裡
里勾外连	裡勾外連
𩾅	𩸃
丑态	醜態
干完	幹完
于台烟	于台煙
郁气	鬱氣
昵称	暱稱
面馆	麵館
金氏世界紀錄	健力士世界紀錄
正體中文	繁體中文
搭干铺	搭乾鋪
余妙	餘妙
开征	開徵
里面	裡面
制品	製品
防水表	防水錶
側著作	側著作
车站里	車站裡
电视台风	電視台風
宜云	宜云
老姜	老薑
勾魂荡魄	勾魂蕩魄
于振武	于振武
抓著述	抓著述
干锅	乾鍋
陧	隉
挽词	輓詞
官不怕大只怕管	官不怕大只怕管
闲情逸致	閒情逸緻
种放	种放
险	險
拎著者	拎著者
夢著者	夢著者
黄干黑瘦	黃乾黑瘦
萨达姆	薩達姆
干卦	乾卦
行著錄	行著錄
挽诗	輓詩
电梯里	電梯裡
干阿奶	乾阿奶
际	際
裁并	裁併
陆	陸
水来汤里去	水來湯裡去
扑冬	撲鼕
种丹妮	种丹妮
搬斗	搬鬥
陉	陘
陈	陳
合采	合採
陕	陝
厂部	厂部
干酵母	乾酵母
忆	憶
冲下	衝下
冲上	衝上
陪著稱	陪著稱
里应外合	裡應外合
黄曲毒素	黃麴毒素
放著作	放著作
朝著作	朝著作
于都县	于都縣
留著作	留著作
餍	饜
做著	做着
斗草	鬥草
转	轉
轭	軛
轮	輪
软	軟
轨	軌
轩	軒
轪	軑
斗鱼	鬥魚
拉面皮	拉面皮
车	車
项	項
径入	逕入
低著称	低著稱
轼	軾
大蜡	大蜡
轾	輊
轿	轎
轸	軫
轹	轢
轺	軺
轻	輕
轴	軸
轵	軹
轶	軼
轷	軤
轰	轟
轱	軲
轲	軻
轳	轤
陈升	陳昇
仿制	仿製
丰情	丰情
鲚	鱭
酒帘	酒帘
溃	潰
鲜	鮮
双折	雙摺
府干政	府干政
溇	漊
溆	漵
溅	濺
上签字	上簽字
在制品	在制品
鲞	鯗
溼	濕
膵脏	膵臟
数字化	數碼化
竹签	竹籤
豎著名	豎著名
鲐	鮐
风起云涌	風起雲湧
意大利面	意大利麵
得到回复	得到回覆
向往常	向往常
躺著作	躺著作
冒著者	冒著者
凄酸	悽酸
勋爵	勳爵
准确	準確
拼绝	拚絕
痳痹	痳痺
埃及历史	埃及歷史
鲕	鮞
采油	採油
萝卜干	蘿蔔乾
实干	實幹
采风问俗	採風問俗
泛游	泛遊
紮著稱	紮著稱
手表達	手表達
蚁	蟻
蚀	蝕
禁欲	禁慾
蚂	螞
漠里	漠裡
蚕	蠶
干尸	乾屍
求著書	求著書
新庄子	新庄子
庄	莊
黄白术	黃白術
吾为之范我驰驱	吾爲之範我馳驅
裝著者	裝著者
占得	佔得
鞭辟入里	鞭辟入裡
国历来	國歷來
兹	茲
养	養
兴	興
千只能	千只能
兰	蘭
关	關
注明	註明
雾里	霧裡
惠文后	惠文后
困著述	困著述
游标卡尺	遊標卡尺
占後	佔後
占德	佔德
谢华后	謝華后
故云	故云
瞪著者	瞪著者
兖	兗
兑	兌
铝制	鋁製
墨斗	墨斗
发型	髮型
空余	空餘
鲇	鯰
于品海	于品海
忙著者	忙著者
加彭	加蓬
側著述	側著述
鲹	鰺
心系唐	心繫唐
夏历	夏曆
鲺	鯴
营干	營幹
流征	流徵
不食干腊	不食乾腊
余响	餘響
只眼	隻眼
多只須	多只須
划入	劃入
卵与石斗	卵與石鬥
數位相機	數碼相機
余额	餘額
困著錄	困著錄
黄岩县	黃巖縣
回佣	回佣
鲱	鯡
星期后	星期後
看得著	看得着
澹台	澹臺
诂	詁
多只能	多只能
游憩	遊憩
味著錄	味著錄
鲵	鯢
接著	接着
学家	學家
拉著錄	拉著錄
鲷	鯛
于尔里克	于爾里克
大金发苔	大金髮苔
好斗胆	好斗膽
多只比	多只比
发妻	髮妻
耀著	耀着
掙著書	掙著書
琴钟	琴鐘
鲬	鯒
石杠	石杠
斗武	鬥武
鲭	鯖
荧郁	熒鬱
得克萨斯	德克薩斯
鲯	鯕
學著名	學著名
布告	佈告
于大宝	于大寶
境里	境裡
路面	路面
穩占	穩佔
车里	車裡
圍著述	圍著述
鲢	鰱
松懈	鬆懈
准式	準式
紐西蘭	新西蘭
磨面	磨麵
連著	連着
郁郁不乐	鬱鬱不樂
心系川	心繫川
跑著作	跑著作
荡船	蕩船
了若指掌	瞭若指掌
采好	採好
經有云	經有云
垂范	垂範
乱发脾气	亂發脾氣
秀发村	秀發村
犯不著述	犯不著述
荡舟	蕩舟
五扎	五紮
郁积	鬱積
纏著稱	纏著稱
颠干倒坤	顛乾倒坤
程序员	程式設計師
饥荒	饑荒
會占	會佔
抬著述	抬著述
筑西	筑西
1周后	1周後
渴著錄	渴著錄
疑著名	疑著名
筝	箏
昆苏	崑蘇
敞著述	敞著述
斗法	鬥法
托梦	託夢
双胜类	雙胜類
涂羽卿	涂羽卿
趕著述	趕著述
臣仆	臣僕
9字节	9位元組
抬著作	抬著作
戬	戩
摸钟	摸鐘
代表著書	代表著書
股栗	股慄
余十	餘十
明鉴	明鑑
曹子里	曹子里
衡鉴	衡鑑
抱素怀朴	抱素懷樸
洗发	洗髮
卤煮	滷煮
洞里萨	洞里薩
风采	風采
算历史	算歷史
白发其事	白發其事
风里	風裡
占至多	佔至多
郁郁菲菲	郁郁菲菲
采摭	採摭
悦	悅
吁请	籲請
占超過	佔超過
干纲	乾綱
嫌凶	嫌兇
展著作	展著作
夸诞	誇誕
金表情	金表情
桌几	桌几
公历	公曆
夸说	誇說
幾內亞比索	幾內亞比紹
莽荡	莽蕩
沾益	霑益
悯	憫
掙著述	掙著述
九扎	九紮
钟表停	鐘錶停
台历史	台歷史
打谷	打穀
夸诩	誇詡
活著書	活著書
天神之后	天神之后
金表现	金表現
脑干	腦幹
旧	舊
无	無
制鞋	製鞋
飄著錄	飄著錄
一地里	一地裡
旸	暘
3只支援	3只支援
时	時
鼍	鼉
激斗	激鬥
鼋	黿
皺著書	皺著書
围	圍
鸡奸	雞姦
玻里尼西亞	波利尼西亞
鼹	鼴
下著作	下著作
睡著述	睡著述
丑旦	丑旦
丑日	丑日
戰著	戰着
㛣	㜏
葉門	也門
代表著者	代表著者
頂著	頂着
慣著述	慣著述
毛坏	毛坏
高几	高几
𩧱	𩥉
下签定	下簽定
臜	臢
细炼	細鍊
打钟	打鐘
𤇄	熌
東湖里	東湖里
本出戏	本齣戲
鉴察	鑑察
小只有	小只有
語著名	語著名
凶刀	兇刀
材干	材幹
摟著者	摟著者
潮涌	潮湧
朴实	樸實
韬	韜
借以	藉以
笔秃墨干	筆禿墨乾
韩	韓
韨	韍
韧	韌
扼肮拊背	搤肮拊背
界里	界裡
聞得著	闻得着
菲利普亲王	菲臘親王
钟面	鐘面
谘	諮
韵	韻
私欲	私慾
谞	諝
著它	着它
扯面	扯麵
郁塞	鬱塞
美著者	美著者
因著者	因著者
丑表功	丑表功
扑咚咚	撲鼕鼕
刻著書	刻著書
萧参	蕭蔘
饥渴	饑渴
聖露西亞	聖盧西亞
盛赞	盛讚
哀吊	哀弔
施舍	施捨
斗胜	鬥勝
运	運
维系统	維系統
布阵	佈陣
迟	遲
远	遠
违	違
定著名	定著名
进	進
还	還
布防	佈防
过	過
系上头	繫上頭
国历任	國歷任
迁	遷
发披肩	髮披肩
戗	戧
迈	邁
迳	逕
复函数	複函數
谊	誼
殷鉴	殷鑑
斗私批修	鬥私批修
甜著錄	甜著錄
𨉗	軉
惨淡	慘澹
诗云	詩云
两鼠斗穴	兩鼠鬥穴
伊斯兰历	伊斯蘭曆
索马里	索馬里
伊適杰	伊適杰
迩	邇
金圣叹	金聖歎
分占	分佔
繫着	繫着
调	調
吹著名	吹著名
男仆	男僕
仇隙	讎隙
松弛	鬆弛
郭后	郭后
𨱉	鍄
心细如发	心細如髮
𡞱	㜢
于小偉	于小偉
冷面相	冷面相
沿著錄	沿著錄
涌水	湧水
𧉞	䗿
𨱆	龯
占好	佔好
遗范	遺範
刻著名	刻著名
丝发	絲髮
白朴	白樸
悠荡	悠蕩
于仁泰	于仁泰
馬占山	馬占山
眬	矓
折戟沈河	折戟沈河
白术	白朮
墨子里	墨子里
灘涂	灘涂
眦	眥
标致	標緻
夏于喬	夏于喬
鹮	䴉
共和历	共和曆
功勋	功勳
多占	多佔
心系台	心繫台
跟著述	跟著述
锎	鐦
推托	推託
空著稱	空著稱
亞斯文	阿斯旺
发夹	髮夾
飘游	飄遊
圈里	圈裡
占市	佔市
谵	譫
锊	鋝
挨著述	挨著述
谴	譴
向著者	向著者
𨱕	𨮂
㘎	㘚
松脆	鬆脆
機械系	機械系
谷胱	穀胱
个中原因	箇中原因
郘钟	郘鐘
舍命	捨命
葉陽后	葉陽后
持著錄	持著錄
𨱑	鐄
卷入	捲入
只身材	只身材
发油	髮油
冉有仆	冉有僕
食欲	食慾
历本	曆本
著衣	着衣
干不成	幹不成
干结	乾結
戀著書	戀著書
心系和	心繫和
枕著錄	枕著錄
望著者	望著者
斗哄	鬥鬨
挂钩	掛鈎
干练	幹練
谠	讜
備著述	備著述
世纪钟	世紀鐘
干绷	乾繃
谦	謙
公历史	公歷史
斗狠	鬥狠
削面	削麵
刮风后	颳風後
葱郁	蔥鬱
3天后	3天後
注册	註冊
順著述	順著述
班固著	班固著
于宝轩	于寶軒
高著述	高著述
戰著者	戰著者
游艇	遊艇
杂面	雜麵
谷日	穀日
谷旦	穀旦
游艺	遊藝
绮	綺
于台煙	于台煙
性欲	性慾
浮松	浮鬆
注解	註解
红后假说	紅后假說
坐台鐵	坐台鐵
流荡	流蕩
穆罕默德历史	穆罕默德歷史
芮氏規模	黎克特制震級
浑个	渾箇
点钟	點鐘
山崩钟应	山崩鐘應
钟头	鐘頭
钟太	鐘太
继	繼
尽管	儘管
懷著者	懷著者
披著錄	披著錄
西历次	西歷次
么弟	么弟
绺	綹
本著錄	本著錄
丰容	丰容
藏著錄	藏著錄
于斯达尔	于斯達爾
折子	摺子
掌柜	掌柜
汇算	彙算
数只应	數只應
沿著名	沿著名
繁钟	繁鐘
喂了一聲	喂了一聲
郁伊	鬱伊
𩲒	𩳤
哗嚣	譁囂
特制住	特制住
重游	重遊
靠著录	靠著錄
簡訊	短訊
操作钟	操作鐘
金表演	金表演
松脱	鬆脫
古钟	古鐘
锲而不舍	鍥而不捨
悠著者	悠著者
丑剌剌	醜剌剌
干灯盏	乾燈盞
飞刍挽粟	飛芻輓粟
3只	3隻
锻	鍛
绉	縐
戰著作	戰著作
薙发	薙髮
于奇庫杜克	于奇庫杜克
沈郁	沈鬱
仆夫	僕夫
麦克尔	米高
守著	守着
做著者	做著者
锶	鍶
卤了	滷了
火签	火籤
野游	野遊
绌	絀
经	經
纏著作	纏著作
誉	譽
張杰	張杰
求著稱	求著稱
娄	婁
帝后台	帝后臺
赌斗	賭鬥
百只足够	百只足夠
誊	謄
干颡	乾顙
回复帖子	回覆帖子
𫍰	諰
𫍲	謏
渔	漁
渗	滲
著重	着重
渑	澠
并迭	并迭
渍	漬
渌	淥
𫍢	譊
渎	瀆
渊	淵
盛著者	盛著者
干漆	乾漆
披头散发	披頭散髮
给	給
披著名	披著名
折纸	摺紙
面粉碎	面粉碎
𫍙	訑
挥手表	揮手表
冒著錄	冒著錄
弥山遍野	瀰山遍野
棫朴	棫樸
生发生	生發生
四周后	四周後
温	溫
娈	孌
賢后	賢后
掖著名	掖著名
艸木丰丰	艸木丰丰
溢著作	溢著作
梳著述	梳著述
拮据	拮据
蜡	蠟
肠脏	腸臟
水里高級商工	水里高級商工
绑	綁
这出版	這出版
發布	發佈
娲	媧
二虎相斗	二虎相鬥
干家	幹家
克剥	剋剝
采猎	採獵
绔	絝
髡发	髡髮
頒布	頒佈
压制出	壓製出
绗	絎
蜗	蝸
隨著名	隨著名
踩著名	踩著名
捉奸贼	捉奸賊
荡漾	蕩漾
鲙	鱠
潜水钟表	潛水鐘錶
鲛	鮫
跳著	跳着
鲝	鮺
数	數
鲟	鱘
伴著錄	伴著錄
鲑	鮭
鲒	鮚
鲓	鮳
揮著名	揮著名
藤席	藤蓆
戰著錄	戰著錄
鲗	鰂
鲈	鱸
鲉	鮋
鲊	鮓
鲋	鮒
鲌	鮊
鲍	鮑
鲎	鱟
鲏	鮍
鲀	魨
鲁	魯
鲂	魴
鲃	䰾
鲄	魺
鲅	鮁
鲆	鮃
敩	斆
鲸	鯨
逆著書	逆著書
䀥	䁻
鲻	鯔
鱼干	魚乾
松饼	鬆餅
鲾	鰏
鲿	鱨
鲰	鯫
丑脸	醜臉
鲲	鯤
鲳	鯧
鲴	鯝
敛	斂
没事干	沒事幹
鲨	鯊
鲩	鯇
鲪	鮶
嚷著稱	嚷著稱
懷著錄	懷著錄
冲起	衝起
鲮	鯪
排干部	排幹部
鲠	鯁
鲡	鱺
敌	敵
鲣	鰹
鲤	鯉
鲥	鰣
保障著錄	保障著錄
鲧	鯀
钟模	鐘模
陪著書	陪著書
发光可鉴	髮光可鑑
蝼	螻
淫欲	淫慾
订制	訂製
外面包	外面包
著意	着意
定著者	定著者
范文	範文
管著書	管著書
秀发生	秀發生
公厘	毫米
发面	發麵
0余	0餘
𫗧	餗
儒略历史	儒略歷史
𪨗	屩
柱梁	柱樑
響著名	響著名
裹著者	裹著者
鬒发	鬒髮
游山玩水	遊山玩水
撼著作	撼著作
牽著名	牽著名
布蘭登堡	勃蘭登堡
发蜡	髮蠟
𩨇	䮫
𩬣	𩭙
嚷著	嚷着
捞面	撈麵
诗钟	詩鐘
大明历	大明曆
贾后	賈后
用著書	用著書
绩	績
太空梭	穿梭機
绫	綾
绪	緒
续	續
绬	緓
绯	緋
花马吊嘴	花馬弔嘴
绡	綃
绠	綆
綁著作	綁著作
绢	絹
绥	綏
绤	綌
賓拉登	本拉登
绦	絛
绹	綯
绸	綢
绻	綣
粗制	粗製
绽	綻
综	綜
甜著名	甜著名
绾	綰
绱	鞝
绰	綽
绳	繩
绲	緄
绵	綿
维	維
绷	繃
绶	綬
大干	大幹
终	終
绋	紼
绊	絆
绍	紹
蓝淀	藍澱
得著作	得著作
绎	繹
绁	紲
绀	紺
练	練
绂	紱
绅	紳
组	組
织	織
细	細
于海拔	於海拔
绘	繪
绛	絳
绚	絢
閉著作	閉著作
络	絡
统	統
绞	絞
逆著稱	逆著稱
绐	紿
结	結
绒	絨
绕	繞
网站里	網站裡
苹果	蘋果
绖	絰
标志	標誌
保障著名	保障著名
于慎行	于慎行
选手表决	選手表決
自然数里	自然數裡
閑著	閑着
占山为	佔山為
筑肥	筑肥
徕	徠
干折	乾折
瞄准	瞄準
盲干	盲幹
亿天后	億天後
瑞征	瑞徵
径	徑
斗鸡	鬥雞
喝著書	喝著書
杯面	杯麵
列印	打印
斗鸭	鬥鴨
当当	噹噹
凄苦	悽苦
孟德爾頌	孟德爾遜
干熬	乾熬
𩙩	𩘀
冲杀	衝殺
抑郁	抑鬱
淀粉	澱粉
循著名	循著名
社里	社裡
心系十	心繫十
虾面	蝦麵
味著称	味著稱
𥹥	𥼽
求著作	求著作
𪾢	睍
尸鸠	尸鳩
卷烟	捲菸
慈溪	慈谿
预报不准	預報不準
暗著者	暗著者
五谷王北街	五谷王北街
多只	多隻
缝制	縫製
尝	嘗
采过	採過
藏著述	藏著述
固著	固着
显示表现	顯示表現
方法里	方法裡
斥著名	斥著名
阿布達比	阿布扎比
呜	嗚
守著稱	守著稱
肉干	肉乾
裝著述	裝著述
黑长发	黑長髮
于斌	于斌
钟快	鐘快
船只有	船只有
心系千	心繫千
公仔面	公仔麵
蒙著名	蒙著名
吊谎	弔謊
征训	徵訓
首只	首隻
叮当	叮噹
首发	首發
凄怆	悽愴
朴鲁	樸魯
伙伴	夥伴
划着船	划着船
正杰	正杰
连	連
看著作	看著作
样范	樣範
字母后	字母後
侦	偵
快冲	快衝
重罗面	重羅麵
雜著書	雜著書
诖	詿
坐著者	坐著者
裝著	裝着
心系南	心繫南
一个准	一個準
台面上	檯面上
董氏封发	董氏封髮
毫发	毫髮
挑著者	挑著者
于特森	于特森
0出線	0出線
伊适杰	伊適杰
辦著者	辦著者
回銮	迴鑾
凭闲	憑閑
藏著者	藏著者
看表面	看表面
照著述	照著述
借鉴	借鑑
慣著稱	慣著稱
心系百	心繫百
将占	將佔
胜肽	胜肽
于耘婕	于耘婕
朝著名	朝著名
呒	嘸
酒麹	酒麴
影相吊	影相弔
凶徒	兇徒
擋著名	擋著名
仆虽罢驽	僕雖罷駑
中型钟	中型鐘
凶征	凶徵
旧历	舊曆
瞆	瞶
葉里溫	埃里溫
演著名	演著名
瞒	瞞
靥	靨
龙卷	龍捲
显示表面	顯示表面
阴历史	陰歷史
關著名	關著名
𫐆	轣
庆吊	慶弔
𫐄	軏
己丑	己丑
吉尼斯世界纪录	健力士世界紀錄
瞩	矚
𫐉	軨
來著者	來著者
理完发	理完髮
品鉴	品鑑
𫐓	輮
呆著	呆着
谷物	穀物
𫐐	輗
分子钟	分子鐘
幹著稱	幹著稱
公里海	公里海
几进几出	幾進幾出
点里程	點里程
肉松	肉鬆
映著錄	映著錄
谷贱伤农	穀賤傷農
穫著	穫着
几天后	幾天後
身著稱	身著稱
寓禁于征	寓禁於徵
演著書	演著書
撚须	撚鬚
欲壑难填	慾壑難填
𩨐	𩧆
扑撻	扑撻
蝈	蟈
钟楼	鐘樓
豮	豶
噜苏	嚕囌
變著作	變著作
并吞下	並吞下
文杰	文杰
好斗笠	好斗笠
𫛢	鸋
望著稱	望著稱
谷米	穀米
卷逃	捲逃
斗来斗去	鬥來鬥去
拭干	拭乾
和制英语	和製英語
朝著錄	朝著錄
揮著者	揮著者
𫏋	蹻
澜	瀾
待著	待着
拉面巾	拉面巾
公余	公餘
費米面	費米面
战天斗地	戰天鬥地
𫛛	鳷
仗著稱	仗著稱
盛著稱	盛著稱
𣘓	𣞻
諾鲁	瑙魯
螨	蟎
王后	王后
程十发	程十髮
缜致	縝緻
府干	府幹
余桃	餘桃
采运	採運
苦著錄	苦著錄
𣘷	𣝕
螀	螿
孙杰	孫杰
𣘴	檭
钟慢	鐘慢
么篇	么篇
云尔	云爾
伥	倀
停制	停製
教学钟	教學鐘
巴士拉	巴斯拉
伤	傷
可自制	可自制
面杖	麵杖
占床	佔床
并拢	併攏
老白干	老白乾
打出吊入	打出弔入
余晖	餘暉
游美学务	遊美學務
须根	鬚根
灯	燈
丑名	醜名
著甚麼	着甚麼
味著作	味著作
八只	八隻
胃脏	胃臟
麟游	麟遊
㚯	㜄
面条	麵條
占座	佔座
隔著名	隔著名
仆欧	僕歐
后平路	后平路
漢諾瓦	漢諾威
么蛾子	么蛾子
莫三比克	莫桑比克
佣	傭
佥	僉
吊卷	弔卷
有棱有角	有稜有角
夢著錄	夢著錄
体	體
偬	傯
幸免	倖免
涂天相	涂天相
斗牌	鬥牌
著裝	着裝
伛	傴
于里察	于里察
党怀英	党懷英
松开	鬆開
偿	償
偾	僨
釀著錄	釀著錄
陋著作	陋著作
斗牛	鬥牛
大夸	大誇
撼著	撼着
占高枝	佔高枝
姜还是老的辣	薑還是老的辣
哄动	鬨動
储	儲
伞	傘
蜂涌	蜂湧
于友泽	于友澤
乃系	乃係
余众	餘眾
忙著錄	忙著錄
貴价	貴价
滩	灘
生力面	生力麵
余羡	餘羨
扛著者	扛著者
彩绸	綵綢
關著	關着
昊天不吊	昊天不弔
拎著述	拎著述
里通外国	裡通外國
准不准	準不準
干瘾	乾癮
祢	禰
废后	廢后
须鲨	鬚鯊
部子里	部子里
死里逃生	死裡逃生
戰著稱	戰著稱
利欲	利慾
干瘪	乾癟
困著者	困著者
砻谷	礱穀
晾干	晾乾
武斗	武鬥
里白	裏白
戲彩娛親	戲綵娛親
祃	禡
循著者	循著者
追著	追着
貢寮	貢寮
祎	禕
整出戏	整齣戲
论文里	論文裡
閉著者	閉著者
隔著錄	隔著錄
干茶钱	乾茶錢
钱范	錢範
阿里	阿里
征占	徵佔
简朴	簡樸
丰仪	丰儀
唱游	唱遊
夢著名	夢著名
亮著稱	亮著稱
并叠	併疊
于浩威	于浩威
悠著書	悠著書
喝著	喝着
棱体	稜體
凄怨	悽怨
泸州大曲	瀘州大麯
索馬利亞	索馬里
磨炼	磨鍊
冲掉	衝掉
多周后	多周後
仆妇	僕婦
與著	與着
栗栖溪	栗栖溪
揿	撳
张杰	張杰
響著書	響著書
岁聿云暮	歲聿云暮
只身世	只身世
繃著	繃着
墨沈沈	墨沈沈
托孤	託孤
開著錄	開著錄
試著錄	試著錄
𩧿	䮠
十周后	十周後
火并	火併
咸咸	鹹鹹
卤牛	滷牛
见素抱朴	見素抱樸
稻谷	稻穀
只身为	只身為
湿	濕
十出	十齣
这出道	這出道
后瑞站	后瑞站
云敞	云敞
跑著名	跑著名
挂历	掛曆
朝乾夕惕	朝乾夕惕
下文里	下文裡
干部	幹部
干这	幹這
扎好底子	扎好底子
萝卜	蘿蔔
夸丽	誇麗
拉著者	拉著者
敲钟	敲鐘
范本	範本
嘘	噓
騎著述	騎著述
戴著	戴着
涂長望	涂長望
心系慈	心繫慈
分半钟	分半鐘
𢛯	㦎
划着竹筏	划着竹筏
表转	錶轉
枕著述	枕著述
不每只	不每只
能干戈	能干戈
精制	精製
簖	籪
懞懞懂懂	懞懞懂懂
划来划去	划來划去
发禁	髮禁
咸嘴淡舌	鹹嘴淡舌
松缓	鬆緩
罩著作	罩著作
丰标	丰標
待著書	待著書
咸鸭蛋	鹹鴨蛋
辟划	闢劃
睡不著	睡不着
留发行	留發行
喂！	喂！
大赞	大讚
喂，	喂，
开山辟谷	開山闢谷
后髮FK型星	后髮FK型星
遍布	遍佈
袋表	袋錶
提著者	提著者
改采	改採
定著錄	定著錄
瞞著述	瞞著述
6只	6隻
待著稱	待著稱
计时表	計時錶
谬赞	謬讚
阴沟里翻船	陰溝裡翻船
请君入瓮	請君入甕
采纳	採納
果累累	果纍纍
一伙人	一伙人
铻	鋙
铺	鋪
铹	鐒
铸	鑄
铿	鏗
链	鏈
五周后	五周後
铼	錸
铳	銃
铲	鏟
铱	銥
铰	鉸
铷	銣
银	銀
铵	銨
铴	鐋
铫	銚
铪	鉿
铩	鎩
铨	銓
铯	銫
铮	錚
铭	銘
铬	鉻
铣	銑
铢	銖
铡	鍘
铠	鎧
铧	鏵
铦	銛
铥	銩
铤	鋌
盯著名	盯著名
铚	銍
铙	鐃
铘	鋣
铟	銦
铞	銱
铝	鋁
铜	銅
铓	鋩
铒	鉺
铑	銠
铐	銬
铗	鋏
铖	鋮
铕	銪
铔	錏
铋	鉍
铊	鉈
铉	鉉
下签约	下簽約
铏	鉶
铎	鐸
來著書	來著書
铌	鈮
铃	鈴
铂	鉑
铁	鐵
瘿	癭
铇	鉋
铆	鉚
于明濤	于明濤
铄	鑠
涂姓	涂姓
惇朴	惇樸
公布	公佈
干凉	乾涼
滩席	灘蓆
沈抚	瀋撫
冲力	衝力
干净	乾淨
纣	紂
甜著稱	甜著稱
沈大线	瀋大線
槟	檳
么爸	么爸
何杰	何杰
么爺	么爺
北仑河	北崙河
唯一只	唯一只
徵占	徵佔
纾	紓
冲劲	衝勁
逼著	逼着
线	線
于楓	于楓
板著臉	板着臉
轉著	轉着
高干预	高干預
秒表示	秒表示
才干涉	才干涉
世界杯	世界盃
巴尔干	巴爾幹
應著名	應著名
冲动	衝動
强	強
朝著者	朝著者
心系英	心繫英
駕著者	駕著者
炼金术	鍊金術
舍己为公	捨己為公
沿著稱	沿著稱
吊贺迎送	弔賀迎送
弯	彎
麗著錄	麗著錄
气冲斗牛	氣沖斗牛
张	張
内脏	內臟
鬥著者	鬥著者
㱩	殰
应制得	應制得
㱮	殨
恺撒	凱撒
弑	弒
耀著稱	耀著稱
异	異
弃	棄
开	開
不占凶吉	不占凶吉
蝎虎	蝎虎
付托	付託
疟	瘧
野姜	野薑
顶凶	頂兇
一扎	一紮
苦著名	苦著名
心系募	心繫募
航海历史	航海歷史
著眼	着眼
隔著者	隔著者
望后石	望后石
食面	食麵
御侮	禦侮
周后	周后
渴著稱	渴著稱
受著述	受著述
飄著者	飄著者
陳有后	陳有后
紫姜	紫薑
占優	佔優
心著	心着
語著者	語著者
據著	據着
于山西	於山西
占億	佔億
射雕	射鵰
紮著者	紮著者
域里	域裡
丑剧	醜劇
凝炼	凝鍊
側著稱	側著稱
機器人	機械人
慣著書	慣著書
葛萊美獎	格林美獎
定著稱	定著稱
埘	塒
吊古	弔古
俪	儷
俫	倈
俨	儼
合伙人	合伙人
俭	儉
俣	俁
安哈特	安哈爾特
心系家	心繫家
喝著稱	喝著稱
有发头陀寺	有髮頭陀寺
西历任	西歷任
芒果干	芒果乾
解铃仍须系铃人	解鈴仍須繫鈴人
心系它	心繫它
数字钟表	數字鐘錶
吊著	吊着
悬梁	懸樑
西历代	西歷代
鄭凱云	鄭凱云
胡杰	胡杰
后台老板	後台老板
陋著	陋着
升高后	升高後
涂敏恆	涂敏恆
哥斯大黎加	哥斯達黎加
须鲸	鬚鯨
脱谷机	脫穀機
整只	整隻
就范	就範
涂敏恒	涂敏恆
只身受	只身受
商历史	商歷史
欲障	慾障
軟體動物	軟體動物
人欲	人慾
剥制	剝製
秋千	鞦韆
卷轴	捲軸
万个	萬個
潭里	潭裡
斯堪地那維亞	斯堪的納維亞
掙著錄	掙著錄
暗里	暗裡
𡋀	𡓾
云游	雲遊
远游	遠遊
位准	位準
蓊郁	蓊鬱
千只足夠	千只足夠
當著書	當著書
𡋗	𡑭
六余	六餘
欢	歡
诜	詵
代表著名	代表著名
掖著作	掖著作
泄欲	洩慾
斗暴	鬥暴
这出	這齣
蚬	蜆
采伐	採伐
定著	定着
历数书	曆數書
活著名	活著名
想著名	想著名
接著錄	接著錄
旧历史	舊歷史
山梁	山樑
賈后	賈后
谷圭	穀圭
斯洛維尼亞	斯洛文尼亞
李連杰	李連杰
乾象历	乾象曆
大衍历	大衍曆
相并	相併
划著	劃著名
相干	相干
寮人民民主共和國	老撾人民民主共和國
长发姑娘	長髮姑娘
寒栗	寒慄
拿准	拿準
制浆	製漿
守著者	守著者
苦斗	苦鬥
隽	雋
釀著述	釀著述
掖著稱	掖著稱
奏折	奏摺
醯酱	醯醬
尸鳩	尸鳩
冲撞	衝撞
惊赞	驚讚
征友	徵友
征发	徵發
穿著名	穿著名
戴著作	戴著作
臨著錄	臨著錄
征召	徵召
灵昆	靈崑
干馏	乾餾
噪诈	譟詐
范式	範式
纤夫	縴夫
跟著錄	跟著錄
于江震	于江震
代表著述	代表著述
谷舱	穀艙
余思	餘思
一锅面	一鍋麵
鹅准	鵝準
漤	灠
好签	好籤
十只	十隻
背著書	背著書
亮著述	亮著述
夸耀	誇耀
擋著者	擋著者
匏系	匏繫
不加自制	不加自制
特征	特徵
干上	幹上
公仆	公僕
得著錄	得著錄
岫岩	岫巖
过水面	過水麵
干丝	乾絲
厄瓜多尔	厄瓜多爾
貝里斯	伯利茲
钟鼓	鐘鼓
钟鼎	鐘鼎
吊慰	弔慰
萨	薩
新扎	新紮
暂	暫
萧	蕭
萦	縈
营	營
递回	遞迴
萚	蘀
游客	遊客
萝	蘿
亮著錄	亮著錄
鹆	鵒
臨著稱	臨著稱
炼形	鍊形
局促	侷促
转向	轉向
余步	餘步
结伴同游	結伴同遊
鹁	鵓
涂紹煃	涂紹煃
于軍	于軍
一厘一毫	一釐一毫
点多钟	點多鐘
赞佩	讚佩
擢发	擢髮
郁律	鬱律
伙计	夥計
打干	打幹
逼著錄	逼著錄
占個位	佔個位
花盆里	花盆裡
䜣	訢
院里	院裡
壓著	壓着
䜧	䜀
信著書	信著書
䜥	𧩙
显示表	顯示錶
哭著	哭着
𢙓	懀
灰蒙蒙	灰濛濛
涂謹申	涂謹申
沉著者	沉著者
晋	晉
范文正公	范文正公
痒	癢
占卜	占卜
间里	間裡
晒	曬
著急	着急
蒙著者	蒙著者
晖	暉
晔	曄
晕	暈
丑丑	醜醜
頂著作	頂著作
吊丧	弔喪
生发	生髮
吃著	吃着
发际	髮際
熏香	薰香
看著名	看著名
咸类	鹹類
余窍	餘竅
高著稱	高著稱
記著名	記著名
毛姜	毛薑
斥著述	斥著述
求著名	求著名
通历史	通歷史
開著者	開著者
占国	佔國
朴拙	樸拙
點著	點着
心系美	心繫美
有著	有着
吹著錄	吹著錄
C型肝炎	丙型肝炎
鬥著	鬥着
洪谷子	洪谷子
干死	乾死
接著述	接著述
四余	四餘
干的好事	幹的好事
几个	幾個
余缺	餘缺
帶著書	帶著書
身著者	身著者
占四	佔四
于湘兰	于湘蘭
舍得	捨得
历法	曆法
心系群	心繫群
𨸆	𨵩
单于	單于
唇干	唇乾
花不要采	花不要採
𨸇	𨵸
仗著書	仗著書
配著述	配著述
几上	几上
赞一个	讚一個
逆钟	逆鐘
占囁	佔囁
與著書	與著書
心系山	心繫山
官历史	官歷史
格里高利历	格里高利曆
流风余韵	流風餘韻
怪里怪气	怪裡怪氣
踩著作	踩著作
秽	穢
惧	懼
穿著稱	穿著稱
靓	靚
快快当当	快快當當
惨	慘
汤团	湯糰
准度	準度
聖克里斯多福及尼維斯	聖吉斯納域斯
別著	別着
国历届	國歷屆
循著錄	循著錄
洪范	洪範
鹎	鵯
历始	曆始
馅	餡
懷著作	懷著作
嗅不著	嗅不着
干咳	乾咳
惭	慚
部落发	部落發
静	靜
騎著	騎着
罩著名	罩著名
惮	憚
秃	禿
种	種
在山里	在山裡
于非闇	于非闇
𨸋	𨶲
打著稱	打著稱
光著名	光著名
干的	乾的
庼	廎
后苍	后蒼
占壓	佔壓
揮著稱	揮著稱
捉奸细	捉奸細
系辞	繫辭
扪	捫
扫	掃
㳔	濧
页面	頁面
鹈	鵜
庞	龐
废	廢
好斗大	好斗大
墓志铭	墓志銘
朴樕	樸樕
应	應
干咽	乾咽
字汇	字彙
这么干	這麼幹
㳠	澾
㳢	𣾷
㳽	瀰
并网	併網
于山东	於山東
馊	餿
布设	佈設
这只容	這只容
绨	綈
后羿	后羿
余闰	餘閏
達著述	達著述
信著稱	信著稱
守著述	守著述
伴著述	伴著述
肉羹面	肉羹麵
蒙著書	蒙著書
晃著稱	晃著稱
干探	幹探
乘著作	乘著作
駕著稱	駕著稱
杂志	雜誌
閉著稱	閉著稱
若干	若干
獲著者	獲著者
醜著	醜着
涂澤民	涂澤民
博采	博採
帶著名	帶著名
滩涂	灘涂
摄制	攝製
𠲥	𡅏
并发展	並發展
补注	補註
干和	乾和
这只是	這只是
于建嶸	于建嶸
窝	窩
拼死拼活	拼死拼活
党太尉	党太尉
狝	獮
函数里	函數裡
順著名	順著名
刘佳怜	劉佳怜
糊口	餬口
之钟	之鐘
被里	被裡
郁堙不偶	鬱堙不偶
柜子	柜子
光著錄	光著錄
夸人	誇人
么女	么女
爭著述	爭著述
夸了	誇了
布景	佈景
敲扑	敲扑
𪔭	𪔵
干道	幹道
电码表	電碼表
制冰	製冰
制冷	製冷
C肝	丙肝
智慧財產權	知識產權
闫怀礼	閆懷禮
只身前	只身前
其余	其餘
中国国际信托投资公司	中國國際信托投資公司
采樵人	採樵人
夸容	誇容
赞歌	讚歌
于姓	于姓
𠯠	噅
铯钟	銫鐘
并到	併到
皮制服	皮制服
巨制	巨製
尋著錄	尋著錄
涂坤	涂坤
夸官	誇官
砰当	砰噹
三准	三準
視著者	視著者
那只在	那只在
表里山河	表裏山河
封后	封后
托运	託運
于成龍	于成龍
胰脏	胰臟
绣	繡
幫著述	幫著述
循著稱	循著稱
籴	糴
于成龙	于成龍
棱角	稜角
征文	徵文
懞直	懞直
面包	麵包
里通外敌	裡通外敵
尸罗精舍	尸羅精舍
制图	製圖
邹	鄒
青霉	青黴
芮氏4	黎克特制4
芮氏5	黎克特制5
芮氏6	黎克特制6
芮氏7	黎克特制7
芮氏0	黎克特制0
芮氏1	黎克特制1
芮氏2	黎克特制2
芮氏3	黎克特制3
么叔	么叔
芮氏8	黎克特制8
芮氏9	黎克特制9
雜著錄	雜著錄
东游	東遊
划着獨木舟	划着獨木舟
數碼訊號	數碼訊號
棺材里	棺材裡
于海洋	于海洋
几筵	几筵
宝历	寶曆
气郁	氣鬱
皑	皚
钟不敲不响	鐘不敲不響
叶阳后	葉陽后
𫔎	鐍
勤朴	勤樸
裹著作	裹著作
亦云	亦云
搋面	搋麵
仆射	僕射
金范	金範
皲	皸
旧表	舊錶
皱	皺
很凶	很兇
纏著書	纏著書
赡	贍
赢	贏
赣	贛
钟有	鐘有
于山	于山
反复	反覆
小只可	小只可
赵	趙
赶	趕
长发公主	長髮公主
沈阳	瀋陽
学里	學裡
宗周钟	宗周鐘
资	資
摟著稱	摟著稱
中签订	中簽訂
赇	賕
赀	貲
赁	賃
赂	賂
寫著者	寫著者
赌	賭
境里程	境里程
冲刺	衝刺
赏	賞
赈	賑
赉	賚
赊	賒
赋	賦
赔	賠
很准	很準
赖	賴
加氢精制	加氫精制
赐	賜
赑	贔
赒	賙
改制成	改制成
赜	賾
赝	贗
赞	贊
赟	贇
塞席爾	塞舌爾
赙	賻
住著作	住著作
赛	賽
大型钟面	大型鐘面
漫著者	漫著者
展著	展着
梿	槤
梾	棶
梼	檮
干产	乾產
松绑	鬆綁
梦	夢
美著書	美著書
研制	研製
舍死忘生	捨死忘生
側著書	側著書
的山里	的山裡
淫荡	淫蕩
𦛨	朥
本著述	本著述
干些	幹些
干了	幹了
飄著述	飄著述
隔著稱	隔著稱
手表決	手表決
不斗	不鬥
干事	幹事
旁注	旁註
落发	落髮
跳著錄	跳著錄
苦著稱	苦著稱
扎囮	紮囮
恳托	懇託
聽著述	聽著述
谷类	穀類
太初历	太初曆
范文照	范文照
北回线	北迴線
挨著	挨着
蒌	蔞
蒉	蕢
蒋	蔣
于光远	于光遠
光著稱	光著稱
蒇	蕆
干娘	乾娘
跳著作	跳著作
逼著者	逼著者
紐澳良	新奧爾良
宝鉴	寶鑑
凄恻	悽惻
书面	書面
评鉴	評鑑
心长发短	心長髮短
應著者	應著者
秦沈客运	秦瀋客運
殖谷	殖穀
当当丁丁	當當丁丁
吸干	吸乾
蛇发女妖	蛇髮女妖
赞颂	讚頌
掛著	掛着
卷土重来	捲土重來
绿	綠
竪著	竪着
抓著稱	抓著稱
块	塊
坝	壩
坜	壢
坟	墳
坞	塢
坐著作	坐著作
悲郁	悲鬱
𤋏	熡
坚	堅
嬴余	嬴餘
倦游	倦遊
书	書
栗栗	慄慄
乡	鄉
黄杰	黃杰
美著稱	美著稱
行著稱	行著稱
乐	樂
乌	烏
反复制	反複製
梳著稱	梳著稱
义	義
版权信息	版權資訊
臨著書	臨著書
余粮	餘糧
积淀	積澱
显示表格	顯示表格
聖馬爾谷日	聖馬爾谷日
船只得	船只得
站著者	站著者
于震寰	于震寰
划为	劃為
于会泳	于會泳
獲著作	獲著作
于化虎	于化虎
解析度	解像度
猜三划五	猜三划五
的个中	的箇中
遗传钟	遺傳鐘
划動	划動
凶器	兇器
里头	裡頭
谷禄	穀祿
石英钟	石英鐘
𥐯	𥖅
硷	鹼
涂鴻欽	涂鴻欽
犯不著名	犯不著名
樂著錄	樂著錄
确	確
𥐻	碙
褴	襤
伟	偉
拿著	拿着
𥐰	𥕥
馄饨面	餛飩麵
䗖	螮
硙	磑
硗	磽
澛	瀂
硕	碩
𥐟	礒
床席	床蓆
表针	錶針
工作台	工作檯
硅	矽
硁	硜
础	礎
干起来	幹起來
择	擇
制著述	制著述
铜范	銅範
于坚	于堅
”	」
这只须	這只須
余喘	餘喘
對著作	對著作
县里	縣裡
西臺國	赫梯國
系上丝	繫上絲
蒸干	蒸乾
注脚	註腳
托儿	託兒
豆腐干	豆腐乾
才干扰	才干擾
相克制	相克制
鹰鵰	鹰鵰
破鉴	破鑑
蘸著稱	蘸著稱
于德海	于德海
1字节	1位元組
數著述	數著述
游错	遊錯
上签写	上簽寫
理次发	理次髮
短发	短髮
准新娘	準新娘
附著錄	附著錄
尸谏	尸諫
趕著書	趕著書
杂合面儿	雜合麵兒
面包罗	面包羅
彦	彥
捆著者	捆著者
上签约	上簽約
谷人	穀人
干酪	乾酪
对表扬	對表揚
夢著	夢着
郁症	鬱症
𠴢	𡄔
采血	採血
于帥	于帥
心系茶	心繫茶
课余	課餘
奖杯	獎盃
细如发	細如髮
刮胡	刮鬍
个钟	個鐘
不吊，	不弔，
采空区	採空區
彨	彲
浪荡	浪蕩
球台	球檯
文征明	文徵明
采补	採補
郁蒸	鬱蒸
钟山	鐘山
揮著作	揮著作
铲头	剷頭
牛轧	鳥結
姜片	薑片
么姨	么姨
么姓	么姓
山重水复	山重水複
天文历表	天文曆表
数只能	數只能
复数	複數
横梁	橫樑
市里的	市裡的
做著述	做著述
帶著稱	帶著稱
䞐	賰
复字键	複字鍵
壽天里	壽天里
刻著	刻着
轉著錄	轉著錄
彩線	綵線
䞍	䝼
䞌	𧵳
排骨面	排骨麵
䞎	𧶧
一天后	一天後
余毒	餘毒
于鳳至	于鳳至
欤	歟
区里的	區裡的
心著称	心著稱
吉他	結他
躍著稱	躍著稱
淋余土	淋餘土
吊客	弔客
情欲	情慾
点札	點劄
吊宴	弔宴
一哄而散	一鬨而散
疑著錄	疑著錄
信著名	信著名
嘱托	囑託
制签	制籤
豔后	豔后
只占吉	只占吉
柜	櫃
干线	幹線
弄鬼吊猴	弄鬼弔猴
炼贫	鍊貧
夸起	誇起
占马	佔馬
柠	檸
升阳	昇陽
甄后	甄后
虎须	虎鬚
甜咸	甜鹹
萬一只	萬一只
分子云	分子雲
柽	檉
幫著稱	幫著稱
拉著名	拉著名
集团	集團
踏著錄	踏著錄
诺曼底	諾曼第
焖	燜
焘	燾
𫖸	願
晶元	晶片
百谷	百穀
余7	餘7
表盘	錶盤
堪培拉	坎培拉
解封后	解封後
北朝鲜	北韓
达·芬奇	達·文西
容范	容範
内哄	內鬨
夸胜道强	誇勝道強
封为后	封為后
钩	鈎
折篷	摺篷
洒家	洒家
被发入山	被髮入山
克卜勒	開普勒
勃郁	勃鬱
舍入口	舍入口
卢浮宫	羅浮宮
口燥唇干	口燥唇乾
𨁴	𨅍
小只能	小只能
冲压	衝壓
馓	饊
火折子	火摺子
跻	躋
跸	蹕
解发佯狂	解髮佯狂
跶	躂
跷	蹺
践	踐
冲去	衝去
昂著述	昂著述
斗蛐	鬥蛐
年历	年曆
闯	闖
问	問
闭	閉
闬	閈
闫	閆
闪	閃
闩	閂
门	門
闷	悶
闶	閌
闵	閔
间	間
闳	閎
采盐	採鹽
闱	闈
闰	閏
人生天里	人生天里
闾	閭
闽	閩
闼	闥
闻	聞
径取	逕取
闹	鬧
闸	閘
靠著称	靠著稱
头里	頭裡
寮采	寮寀
干量	乾量
干重	乾重
弘历	弘曆
昆调	崑調
記著者	記著者
于凤至	于鳳至
迫著	迫着
渴著	渴着
范围	範圍
盯著作	盯著作
生华发	生華髮
队里	隊裡
质朴	質樸
斗龙	鬥龍
欺蒙	欺矇
帅	帥
奋斗	奮鬥
币	幣
帏	幃
總裁制	總裁制
师	師
纡回	紆迴
的发小	的髮小
忧郁	憂鬱
历物之意	厤物之意
帐	帳
待复	待覆
帜	幟
帘	簾
带	帶
帧	幀
沈丹高	瀋丹高
阳春面	陽春麵
占新	佔新
狐借虎威	狐藉虎威
9只支持	9只支持
奧黛麗·赫本	柯德莉·夏萍
于国桢	于國楨
帱	幬
北岳	北嶽
帼	幗
帻	幘
这只可	這只可
排干	排乾
躺著書	躺著書
蒙著	蒙着
六么	六么
余留	餘留
咸批	鹹批
收錄著	收錄着
騙著錄	騙著錄
选手表明	選手表明
㐹	㑶
打干哕	打乾噦
㐽	偑
食欲不振	食欲不振
印著作	印著作
㐷	傌
暗著稱	暗著稱
别辟	別闢
占個	佔個
宋王台	宋王臺
不干不净	不乾不淨
于寶軒	于寶軒
畫著稱	畫著稱
励	勵
绝	絕
劳	勞
小丑	小丑
有事之无范	有事之無範
图里，	圖裡，
剪彩	剪綵
蓄胡	蓄鬍
占滿	佔滿
借寇兵	藉寇兵
留著書	留著書
占满	佔滿
變著稱	變著稱
杰威尔	杰威爾
有著者	有著者
图	圖
国	國
优游	優遊
想著述	想著述
囵	圇
肴馔	肴饌
囱	囪
心荡	心蕩
园	園
刮雪	颳雪
一天钟	一天鐘
赞辞	讚辭
腌臜	腌臢
奈及利亞	尼日利亞
威斯伐倫	威斯特法倫
精制住	精制住
趴著者	趴著者
撞钟	撞鐘
𩯒	𩯳
華勒沙	華里沙
朝钟	朝鐘
雜著述	雜著述
面粉	麵粉
办	辦
酸姜	酸薑
開著述	開著述
于澤爾	于澤爾
王侯后	王侯后
冲散	衝散
浪游	浪遊
认准	認準
栉发工	櫛髮工
看不著	看不着
采为	採為
台钟	台鐘
干落	乾落
薴烯	薴烯
雇请	僱請
采下	採下
脏胸	臟胸
于海	于海
法里，	法裡，
买凶	買兇
首席执行官	行政總裁
鮮于	鮮于
馁	餒
荐居	荐居
争奇斗异	爭奇鬥異
印鉴	印鑑
范畴	範疇
蔂	虆
義占	意佔
弄丑	弄醜
蓋著稱	蓋著稱
注定	註定
想著稱	想著稱
系上了	繫上了
托庇	託庇
折奏	摺奏
借口	藉口
髭须	髭鬚
准保释	准保釋
蔷	薔
踊	踴
蔼	藹
群丑	群醜
蔺	藺
蔹	蘞
跑著書	跑著書
趴著作	趴著作
律历志	律曆志
里面包	裡面包
馌	饁
站著錄	站著錄
尋著	尋着
波札那	博茨瓦納
埃荣冲	埃榮衝
一物克一物	一物剋一物
十出家	十出家
瘾	癮
㔉	劚
奇迹	奇蹟
样	樣
仅	僅
南岳	南嶽
从	從
栾	欒
哭著名	哭著名
𥅴	䀹
那只是	那只是
面粉红	面粉紅
仓	倉
辽沈	遼瀋
逼著作	逼著作
赞呗	讚唄
苹果干	蘋果乾
凶狠	兇狠
捞干	撈乾
树	樹
煎面	煎麵
们	們
仪	儀
偻	僂
爱河里花子	愛河里花子
栅	柵
价	價
标	標
勾干	勾幹
栀	梔
坛坛罐罐	罈罈罐罐
涌水塘	涌水塘
守著名	守著名
栎	櫟
栉	櫛
栈	棧
栋	棟
栊	櫳
踏著稱	踏著稱
两扎	兩紮
东冲西突	東衝西突
活著作	活著作
里铺	里舖
音不准	音不準
梨干	梨乾
變著	變着
干妹	乾妹
松掉	鬆掉
仆使	僕使
藏著名	藏著名
源代码	原始碼
漫著稱	漫著稱
干妈	乾媽
發著者	發著者
潤著作	潤著作
美著述	美著述
很松	很鬆
照著作	照著作
上签了	上簽了
踪	蹤
很干	很乾
䘞	𧜗
䘛	𧝞
厨余	廚餘
余桶	餘桶
愛河里花子	愛河里花子
趴著錄	趴著錄
骠	驃
骡	騾
选手表现	選手表現
骣	驏
骤	驟
骥	驥
骦	驦
骧	驤
占葡	佔葡
其一只	其一只
骐	騏
骑	騎
站著名	站著名
骓	騅
骔	騌
骕	驌
骖	驂
骗	騙
骘	騭
骙	騤
語著作	語著作
骛	騖
占著	佔着
骝	騮
骞	騫
田里	田裡
骀	駘
骁	驍
骂	罵
骃	駰
骄	驕
骅	驊
骆	駱
骇	駭
骈	駢
骉	驫
骊	驪
骋	騁
验	驗
骍	騂
丑杂	醜雜
吊问	弔問
药签	藥籤
熬制	熬製
二極體	二極管
发长	髮長
杂	雜
权	權
杀	殺
干刍	乾芻
系里	系裡
亮著者	亮著者
恕乏价催	恕乏价催
苏昆	蘇崑
惊栗	驚慄
含著錄	含著錄
杩	榪
力拼众敌	力拼眾敵
杠	槓
条	條
提心吊胆	提心弔膽
自夸	自誇
雅著作	雅著作
诔赞	誄讚
擺著	擺着
隱占	隱佔
月球历表	月球曆表
杰	傑
波士尼亞與赫塞哥維納	波斯尼亞和黑塞哥維那
幫著者	幫著者
杞宋无征	杞宋無徵
罩著書	罩著書
百花历	百花曆
占過	佔過
夸示	誇示
干池	乾池
写字台	寫字檯
舉手表	舉手表
连占	連佔
心系红	心繫紅
㨫	㩜
努力著	努力着
录制	錄製
盆吊	盆弔
面皮	麵皮
精松	精鬆
寶獅	標致
乘著稱	乘著稱
擺著作	擺著作
連著稱	連著稱
見著作	見著作
党懷英	党懷英
保障著	保障着
踩著錄	踩著錄
确系	確係
壓著作	壓著作
鲜于	鮮于
鸾鉴	鸞鑑
丧钟	喪鐘
预制	預製
钟表盘	鐘錶盤
雇用	僱用
忍著作	忍著作
雅范	雅範
并发重症	併發重症
潤著名	潤著名
托买	託買
丑奴儿	醜奴兒
笑著名	笑著名
伊斯兰教历史	伊斯蘭教歷史
痳疹	痳疹
数只包括	數只包括
朱理安历	朱理安曆
划行	划行
钟差	鐘差
困著作	困著作
标准	標準
眼睛里	眼睛裡
没干	沒幹
汹涌	洶湧
著筆	着筆
谷子敬	谷子敬
布谷鸟钟	布穀鳥鐘
轻松	輕鬆
散布	散佈
浸卤	浸滷
石几	石几
心系兰	心繫蘭
自制之力	自制之力
放著名	放著名
还冲	還衝
万只	萬隻
准货币	準貨幣
八周后	八周後
心系全	心繫全
曾朴	曾樸
板荡	板蕩
紐幾內亞	新幾內亞
卷毛	捲毛
吁求	籲求
心系伊	心繫伊
珰	璫
祷	禱
采拾	採拾
新历史	新歷史
光著書	光著書
擋著作	擋著作
自制他	自制他
余辜	餘辜
點著名	點著名
佣钿	佣鈿
抓著錄	抓著錄
心系传	心繫傳
罵著作	罵著作
佣钱	佣錢
凄戾	悽戾
祸	禍
碰钟	碰鐘
妖后	妖后
抱著名	抱著名
星历	星曆
涂泽民	涂澤民
燒著名	燒著名
淀乃不耕之地	澱乃不耕之地
条干	條幹
占上风	佔上風
存折	存摺
凉席	涼蓆
朴质	樸質
节欲	節慾
牛軋	鳥結
戏彩娱亲	戲綵娛親
三極體	三極管
麹霉	麴黴
日历	日曆
顶多	頂多
采气	採氣
余膏	餘膏
涌现	湧現
干瘦	乾瘦
牽著錄	牽著錄
陪著錄	陪著錄
面缸	麵缸
划算	划算
置言成范	置言成範
于冕	于冕
抿发	抿髮
箓	籙
喂喂	喂喂
拖著名	拖著名
祯	禎
松宽	鬆寬
瓦文萨	華里沙
心系灾	心繫災
舂谷	舂穀
猛冲	猛衝
赅	賅
麼著	麼着
哗变	譁變
巧历	巧曆
硅藻	硅藻
耶律术烈	耶律朮烈
昆冈	崑岡
赆	贐
彩船	綵船
于波	于波
水并流	水併流
笑著稱	笑著稱
世纪里	世紀裡
个中道理	箇中道理
假里	假裡
望著作	望著作
干撇下	乾撇下
迪拜	杜拜
小米面	小米麵
𫘨	騠
𥱔	𥵃
𫘤	騃
𫘣	駻
𫘝	駃
恒隆	恒隆
表里不一	表裏不一
回诵	迴誦
占為	佔為
尸佼	尸佼
哭著者	哭著者
游仙	遊仙
病愈	病癒
撼著稱	撼著稱
妇	婦
原文里	原文裡
后綜	后綜
拿破仑	拿破崙
镈	鎛
镋	钂
镊	鑷
廓子里	廓子里
镌	鐫
镏	鎦
镎	鎿
镁	鎂
镀	鍍
镃	鎡
镂	鏤
镅	鎇
氤郁	氤鬱
镇	鎮
镆	鏌
镙	鏍
镘	鏝
镛	鏞
镚	鏰
镝	鏑
镜	鏡
镟	鏇
镞	鏃
于克勒	于克勒
镐	鎬
镓	鎵
镒	鎰
镕	鎔
镔	鑌
镗	鏜
镖	鏢
臊子面	臊子麵
镨	鐠
镫	鐙
镪	鏹
镭	鐳
镬	鑊
镯	鐲
镮	鐶
镡	鐔
镠	鏐
皱折	皺摺
镢	钁
镥	鑥
镤	鏷
镧	鑭
镦	鐓
平平当当	平平當當
办公台	辦公檯
猜著述	猜著述
镱	鐿
镰	鐮
镳	鑣
镲	鑔
鉴于	鑑於
镴	鑞
镶	鑲
个中好手	箇中好手
城市里	城市裡
三余	三餘
六樓后座	六樓后座
于謙	于謙
历象	曆象
油斗	油鬥
扎紧	紮緊
楊雅筑	楊雅筑
个中奥	箇中奧
捆著	捆着
整发用品	整髮用品
打吨	打吨
于謹	于謹
騙著述	騙著述
提比里西	第比利斯
钟腰	鐘腰
衣著書	衣著書
暗著述	暗著述
这只不	這只不
榉	櫸
榈	櫚
榇	櫬
榅	榲
榄	欖
干头	幹頭
复钱	複錢
巴塞隆納	巴塞隆拿
音准	音準
4周后	4周後
跑著稱	跑著稱
尋著作	尋著作
卤味	滷味
鬥著書	鬥著書
順著錄	順著錄
喂哟	喂喲
划具	划具
尽自	儘自
厘毫	釐毫
仆仆	僕僕
发上指冠	髮上指冠
𣐤	欍
仆从	僕從
有够赞	有夠讚
心系北	心繫北
王添灯	王添灯
舍出	捨出
钤	鈐
拉著述	拉著述
相斗	相鬥
夸脱	夸脫
皺著作	皺著作
行凶	行兇
一个	一個
奧黛莉·朵杜	柯德莉·塔圖
住著名	住著名
余俗	餘俗
枪杆	槍桿
合伙	合夥
改征	改徵
瓷制	瓷製
洗炼	洗鍊
翱游	翱遊
𤇃	爄
复分解	複分解
貴子里	貴子里
箱里	箱裡
发胶	髮膠
朝鲜战争	韓戰
黄钟	黃鐘
悬臂梁	懸臂樑
仗著	仗着
甲胄	甲冑
挽车	輓車
聽著名	聽著名
只身	隻身
噜	嚕
链表	鍊表
身著	身着
酒气冲天	酒氣衝天
河里	河裡
弱水三千只取一瓢	弱水三千只取一瓢
价川	价川
裹著書	裹著書
拼著述	拼著述
二余	二餘
心系社	心繫社
姜汤	薑湯
悠著名	悠著名
华严钟	華嚴鐘
谋干	謀幹
后蒼	后蒼
坱郁	坱鬱
蘸著名	蘸著名
触须	觸鬚
好困	好睏
造钟	造鐘
默多克	梅鐸
映著者	映著者
古書云	古書云
蒙眬	矇矓
寫著書	寫著書
趴著稱	趴著稱
告札	告劄
卷云	捲雲
踡局	踡跼
蚁后	蟻后
衣著錄	衣著錄
仁贵	仁貴
筑后	筑後
吃碗面	吃碗麵
涂谨申	涂謹申
坦荡荡	坦蕩蕩
尸利	尸利
已占卜	已占卜
台佟	臺佟
𠛅	剾
𠛆	𠞆
薮	藪
面疙瘩	麵疙瘩
制法	製法
余裕	餘裕
拼死	拚死
占山為	佔山為
判断发	判斷發
不占吉凶	不占吉凶
采花	採花
胡须	鬍鬚
試著述	試著述
隐几	隱几
保障著書	保障著書
樂著作	樂著作
漂荡	漂蕩
舰	艦
征兆	徵兆
敢斗了胆	敢斗了膽
冲然	衝然
寶萊塢	波里活
划拳	划拳
揉著作	揉著作
征兵	徵兵
余部	餘部
布下的	佈下的
丑声远播	醜聲遠播
抱著者	抱著者
上天里	上天里
皮托管	皮托管
放懞挣	放懞掙
格鲁吉亚	格魯吉亞
象徵著	象著着
蚃干	蠁幹
拨谷	撥穀
潤著	潤着
余年	餘年
余干	餘干
心系重	心繫重
征募	徵募
巴伦西亚	華倫西亞
忍著錄	忍著錄
拿著述	拿著述
杜塞道夫	杜塞爾多夫
峦	巒
犹	猶
膠著者	膠著者
連著書	連著書
渗漓	滲灕
夸才	誇才
涂绍煃	涂紹煃
躍著述	躍著述
下签署	下簽署
隐私	私隱
痊愈	痊癒
采去	採去
链接	連結
挽歌	輓歌
哄堂	鬨堂
子云	子云
长几	長几
嘉肴	嘉肴
盯著錄	盯著錄
雇船	僱船
克羅埃西亞	克羅地亞
咸蛋	鹹蛋
干路	幹路
臨著述	臨著述
语有云	語有云
赘	贅
由余	由余
占着	佔着
圣马尔谷日	聖馬爾谷日
挽辞	輓辭
准將	準將
准将	準將
准尉	準尉
变征	變徵
挽输	輓輸
语法里	語法裡
筛	篩
筚	篳
的长发	的長髮
筜	簹
丑贼生	醜賊生
筑	築
衣索比亞	埃塞俄比亞
乱发生	亂發生
渊里	淵裡
叶韻	叶韻
理发	理髮
叶韵	叶韻
钟不空则哑	鐘不空則啞
叫著稱	叫著稱
叶音	叶音
筹	籌
签	簽
筼	篔
聽不著	聽不着
余震	餘震
术赤	朮赤
8只支持	8只支持
筑邦	筑邦
霁	霽
維德角	佛得角
犯不著書	犯不著書
丰標	丰標
辞汇	辭彙
惊	驚
百花历史	百花歷史
御敌	禦敵
布点	佈點
𨸟	䧢
𨸘	𨽏
曲酒	麯酒
包著	包着
𨸄	䦘
𨸅	𨴗
懷著	懷着
总裁制	總裁制
𨸀	𨳕
𨸁	𨳑
𨸂	閍
𨸃	閐
𨸌	𨶮
惩	懲
𨸎	𨷲
惫	憊
惬	愜
𨸉	𨶀
𨸊	𨶏
展著錄	展著錄
藏著	藏着
人数里	人數裡
呆致致	呆緻緻
鹩	鷯
黏著名	黏著名
所云	所云
谷雨	穀雨
扑挞	扑撻
蒲席	蒲蓆
苦著	苦着
钟摆	鐘擺
拼著名	拼著名
代表著錄	代表著錄
尸弃佛	尸棄佛
亮钟	亮鐘
游乐	遊樂
𥮋	𥸠
余责	餘責
炼句	鍊句
袋杆	袋桿
裹著稱	裹著稱
钟陈列	鐘陳列
犊	犢
皓发	皓髮
努力著作	努力著作
西昆	西崑
桑巴舞	森巴舞
𫚉	魟
𫚈	鱮
𫚕	鰤
𫚔	鮰
并科	併科
采矿	採礦
𫚒	鮄
并州	并州
觚棱	觚稜
采石	採石
𫚙	鯆
哀挽	哀輓
国历经	國歷經
一出子	一齣子
四舍五入	四捨五入
美发店	美髮店
低洼	低洼
发髻	髮髻
采石之役	采石之役
导游	導遊
机械表	機械錶
陪著者	陪著者
受著名	受著名
敢情欲	敢情欲
鳟	鱒
管著稱	管著稱
圍著	圍着
因著	因着
下课钟	下課鐘
干雷	乾雷
栏	欄
扎根	紮根
偎干	偎乾
數位化	數碼化
布設	佈設
数只	數隻
懒	懶
于涛	于濤
强干	強幹
著落	着落
回转	迴轉
崂	嶗
崃	崍
崄	嶮
缓征	緩徵
干稿	乾稿
暗著錄	暗著錄
纏著	纏着
辩斗	辯鬥
美发馆	美髮館
面包含	面包含
烟	煙
定著作	定著作
配制饲料	配制飼料
用不著	用不着
夏历史	夏歷史
崭	嶄
饼干	餅乾
于爾根	于爾根
借著錄	借著錄
梳著作	梳著作
𡒄	壈
燎发	燎髮
忙里偷闲	忙裡偷閒
舍入	捨入
铲出	剷出
诚征	誠徵
心系远	心繫遠
倾	傾
下著者	下著者
丽	麗
占北	佔北
心系近	心繫近
征聘	徵聘
裝著名	裝著名
谁干的	誰幹的
干回付	乾回付
文学志	文學誌
嗫	囁
颁	頒
受著錄	受著錄
心系妻	心繫妻
沈海铁路	瀋海鐵路
中签写	中簽寫
占著錄	占著錄
嗳	噯
卷筒	捲筒
郁郁苍苍	鬱鬱蒼蒼
复对数	複對數
好莱坞	荷里活
心系妇	心繫婦
班傑明	本傑明
卤面	滷麵
鹰雕	鹰鵰
躺著錄	躺著錄
抹干	抹乾
秒钟	秒鐘
坑里	坑裡
皮里春秋	皮裡春秋
𨅫	𨇞
郁郁葱葱	鬱鬱蔥蔥
來著名	來著名
𨅬	躝
本著稱	本著稱
汹	洶
澹荡	澹蕩
磨制	磨製
彩楼	綵樓
这只	這隻
丰度	豐度
吹著述	吹著述
鳔	鰾
狄安娜	戴安娜
硗确	磽确
大只在	大只在
巡回	巡迴
系念	繫念
杠杆	槓桿
疑著	疑着
拼著錄	拼著錄
𩨀	騔
系心	繫心
不好干预	不好干預
其二只	其二只
𦨩	𦪽
亞塞拜然	阿塞拜疆
恶直丑正	惡直醜正
仆固怀恩	僕固懷恩
钟在寺里	鐘在寺裡
于学忠	于學忠
钟形	鐘形
复分析	複分析
余地	餘地
丑八怪	醜八怪
舆	輿
應著書	應著書
环游	環遊
漓江	灕江
領著名	領著名
遗迹	遺蹟
撼著名	撼著名
舱	艙
鸠占	鳩佔
采样	採樣
舻	艫
舣	艤
对表明	對表明
苧麻	苧麻
畫著名	畫著名
回风	迴風
理个发	理個髮
辟筑	闢築
郁郁青青	郁郁青青
马拉特·萨芬	馬拉特·沙芬
峰回	峰迴
酒肴	酒肴
瞪著名	瞪著名
味著書	味著書
万历朝鲜战争	萬曆朝鮮戰爭
醜著述	醜著述
臨著	臨着
四只	四隻
两余	兩餘
敞著作	敞著作
閉著名	閉著名
展著稱	展著稱
福著錄	福著錄
浮著名	浮著名
立著名	立著名
余映	餘映
成于思	成於思
沖著	沖着
烟台	煙臺
超级杯	超級盃
发结	髮結
某只	某隻
九周后	九周後
敞著錄	敞著錄
響著稱	響著稱
斗而铸锥	鬥而鑄錐
李连杰	李連杰
于谦	于謙
記著作	記著作
大目干连	大目乾連
趕著錄	趕著錄
制著稱	制著稱
心系新	心繫新
三个	三個
余明	餘明
沿著作	沿著作
行事历	行事曆
殿钟自鸣	殿鐘自鳴
寸发千金	寸髮千金
跑著錄	跑著錄
小型钟表	小型鐘錶
乾象曆	乾象曆
只身上無	只身上無
枯干	枯乾
黎吉云	黎吉雲
庫德人	庫爾德人
杯干	杯乾
圣后	聖后
椝	槼
回文构词	迴文構詞
椟	櫝
椠	槧
椢	槶
椤	欏
雅穆索戈	雅穆蘇克雷
椫	樿
對著稱	對著稱
椁	槨
活著錄	活著錄
椮	槮
费占	費佔
郓	鄆
流著書	流著書
酥松	酥鬆
心系震	心繫震
0出現	0出現
商标准许	商標准許
至多只	至多只
弄干	弄乾
心系泰	心繫泰
所占星	所占星
电波钟	電波鐘
含著述	含著述
篯	籛
篮	籃
授勋	授勳
通历	通曆
斥著作	斥著作
占盡	佔盡
衣索匹亞	埃塞俄比亚
于震環	于震環
点半钟	點半鐘
呗赞	唄讚
已占算	已占算
仙游	仙遊
争奇斗艳	爭奇鬥豔
鳀	鯷
篱	籬
斯皮尔伯格	史匹堡
苏醒	甦醒
余〇	餘〇
编采	編採
干嚎	乾嚎
恒	恆
漫卷	漫捲
抬著稱	抬著稱
紮著名	紮著名
郐	鄶
准直	準直
追著者	追著者
麗著述	麗著述
于默奥	于默奧
恺	愷
恻	惻
殺著者	殺著者
恹	懨
溢著稱	溢著稱
恼	惱
飞扎	飛紮
恳	懇
恶	惡
割舍	割捨
勋劳	勳勞
鹄	鵠
椭	橢
小型钟	小型鐘
马德钟	馬德鐘
西周钟	西周鐘
梁上君子	梁上君子
鹀	鵐
大病初愈	大病初癒
标标致致	標標致致
鸡腿面	雞腿麵
增辟	增闢
不丑	不醜
面条目	面條目
住著書	住著書
固定制	固定制
標志著	標志着
承宣布政	承宣布政
瞪著稱	瞪著稱
干济	幹濟
一吊钱	一吊錢
炒面	炒麵
考著名	考著名
寝	寢
鹕	鶘
鹔	鷫
𤦀	瓕
萬那杜	瓦努阿圖
考著	考着
奸淫掳掠	奸淫擄掠
撷	擷
对	對
寿	壽
导	導
咸水	鹹水
么孃	么孃
烩面	燴麵
撵	攆
跪著作	跪著作
柏林墙	柏林圍牆
卷尾猴	捲尾猴
被夸	被誇
么子	么子
丑小鸭	醜小鴨
醜著書	醜著書
趕著名	趕著名
撺	攛
熏心	薰心
坛	壇
郁郁寡欢	鬱鬱寡歡
斗幌子	鬥幌子
撸	擼
颜范	顏範
磬钟	磬鐘
鹙	鶖
陋著書	陋著書
贤后	賢后
事里	事裡
台球	檯球
并为一体	併為一體
岖	嶇
岗	崗
盘里	盤裡
占不足	佔不足
心系健	心繫健
游程	遊程
岘	峴
岚	嵐
岛	島
钟表速	鐘錶速
岁	歲
岂	豈
朝著稱	朝著稱
白粉面	白粉麵
鹠	鶹
里氏地震规模	黎克特制地震震級
𤞤	玁
䂵	碽
岿	巋
黄历史	黃歷史
岭	嶺
发卷	髮捲
閒著	閒着
卷舌	捲舌
心系世	心繫世
存著作	存著作
赞美	讚美
心系东	心繫東
荡寇	蕩寇
捉奸徒	捉奸徒
鹨	鷚
動著者	動著者
心系万	心繫萬
斗不过	鬥不過
吐哺捉发	吐哺捉髮
心系一	心繫一
凭吊	憑弔
響著作	響著作
夸克	夸克
浑	渾
西历史	西歷史
牽著作	牽著作
篑	簣
后街	后街
跟著稱	跟著稱
心系两	心繫兩
篓	簍
那只须	那只須
心系中	心繫中
丰标不凡	丰標不凡
鹰	鷹
采到	採到
采制	採制
鹳	鸛
复查	複查
发雕	髮雕
鹲	鸏
面塑	麵塑
眼干	眼乾
聞不著	闻不着
綁著名	綁著名
犯不著者	犯不著者
煮制	煮製
傲霜斗雪	傲霜鬥雪
斗打	鬥打
學著者	學著者
浮著錄	浮著錄
循著作	循著作
疑著作	疑著作
属托	屬託
辦著述	辦著述
涂善妮	涂善妮
准点	準點
颡	顙
困著名	困著名
流风余俗	流風餘俗
甲后路	甲后路
俄占	俄佔
映著稱	映著稱
拈须	拈鬚
天里村	天里村
钟纽	鐘紐
采树种	採樹種
包谷	包穀
王余鱼	王餘魚
业	業
事有斗巧	事有鬥巧
寇准	寇準
于濤	于濤
騙著	騙着
仙后座	仙后座
陨	隕
干薪	乾薪
路图里	路圖裡
僮仆	僮僕
皆准	皆準
渠冲	渠衝
許聖杰	許聖杰
陋著述	陋著述
怒发冲冠	怒髮衝冠
不好干預	不好干預
寇仇	寇讎
急著作	急著作
复线	複線
后北街	后北街
刻著称	刻著稱
沈山铁路	瀋山鐵路
𧹑	䞈
金表示	金表示
粪秽蔑面	糞穢衊面
翁子里	翁子里
重制	重製
占西	佔西
炼	煉
為著者	為著者
点	點
炀	煬
炉	爐
·威尔士	·威爾士
布雷。	佈雷。
東協助	東協助
炜	煒
炝	熗
鲼	鱝
余韵	餘韻
狄志杰	狄志杰
俭朴	儉樸
金装玉里	金裝玉裡
少占	少佔
挨著稱	挨著稱
堙淀	堙澱
向著名	向著名
要自制	要自制
尊后	尊后
银朱	銀硃
布吉納法索	布基納法索
编码表	編碼表
夸成	誇成
恋	戀
后海灣	后海灣
鉤	鈎
干当	幹當
美发师	美髮師
冲倒	衝倒
紮著作	紮著作
烟卷	煙捲
折扇	摺扇
干片	乾片
瘅	癉
唱著述	唱著述
瘆	瘮
大衍历史	大衍歷史
范亭	範亭
載著作	載著作
煨干	煨乾
饶	饒
史鉴	史鑑
面食	麵食
心系夫	心繫夫
屯里	屯裡
于默奧	于默奧
干物	乾物
永历史	永歷史
心系大	心繫大
饪	飪
咨询	諮詢
于少保	于少保
郁勃	鬱勃
余暇	餘暇
干员	幹員
日心历表	日心曆表
張三丰	張三丰
电视里	電視裡
求著述	求著述
只占卜	只占卜
沉著	沉着
只身上的	只身上的
恸	慟
虎斗	虎鬥
这只会	這只會
人如风后入江云	人如風後入江雲
顺风后	順風後
纮	紘
色欲	色慾
不锈钢	不鏽鋼
檯	枱
翁山蘇姬	昂山素姬
六天后	六天後
恽	惲
學著錄	學著錄
饤	飣
摧坚获丑	摧堅獲醜
瘗	瘞
反应制得	反應製得
那只需	那只需
身著作	身著作
征效	徵效
用著稱	用著稱
吊纸	弔紙
隨著	隨着
换只	換隻
糊里糊涂	糊裡糊塗
獨裁制	獨裁制
儒略改革历	儒略改革曆
区里有	區裡有
能自制	能自制
躺著述	躺著述
拾沈	拾瀋
闯荡	闖蕩
万旗	万旗
英占	英佔
线图里	線圖裡
夸口	誇口
这只允	這只允
追著錄	追著錄
虫部	虫部
躍著名	躍著名
冷面	冷麵
啭	囀
铛	鐺
啯	嘓
啮	齧
臭气冲天	臭氣衝天
啧	嘖
占压	佔壓
旱干	旱乾
网游	網遊
啸	嘯
啴	嘽
想象	想像
啰	囉
木梁	木樑
于云鹤	于雲鶴
4只支援	4只支援
遨游	遨遊
2只支持	2只支持
豎著稱	豎著稱
台布景	台布景
占去	佔去
騎著名	騎著名
水里鳳林	水里鳳林
占二	佔二
占了	佔了
托病	託病
门帘	門帘
尔冬升	爾冬陞
瘪	癟
占五	佔五
瘫	癱
划船	划船
烫一次发	燙一次髮
揉著	揉着
藉著	藉着
和制汉	和製漢
用得著	用得着
苧悴	薴悴
逆著作	逆著作
涼著作	涼著作
中庄子	中庄子
刻著作	刻著作
尸禄	尸祿
斗叠	鬥疊
傳位于四太子	傳位于四太子
铍	鈹
修筑前	修築前
剪发	剪髮
0只支援	0只支援
占下風	佔下風
大只	大隻
吊词	弔詞
柜柳	柜柳
孙	孫
擇日占星	擇日占星
范文同	范文同
榨干	榨乾
铀	鈾
为准	為準
竞斗	競鬥
卷尺	捲尺
沈著	沈着
孪	孿
好斗蓬	好斗蓬
铅	鉛
白里透红	白裡透紅
應制得	應制得
𤠋	㺏
吊诡	弔詭
复审	複審
芗	薌
芜	蕪
寺钟	寺鐘
镇里	鎮裡
做著作	做著作
松口	鬆口
节	節
笑里藏刀	笑裡藏刀
一出戏	一齣戲
芈	羋
天克地冲	天克地衝
晞发	晞髮
采莲	採蓮
采获	採獲
考征	考徵
俯冲	俯衝
心系阮	心繫阮
注失	註失
飄著名	飄著名
斗艳	鬥豔
陪著述	陪著述
吃姜	吃薑
树林里	樹林裡
繞著述	繞著述
騎著錄	騎著錄
系上绳	繫上繩
干个够	乾個夠
松口镇	松口鎮
住著稱	住著稱
十出头	十出頭
關著書	關著書
葛摩	科摩羅
定著書	定著書
折子戏	折子戲
么爹	么爹
后天	後天
心系京	心繫京
斗闷	鬥悶
只身後	只身後
籃板球	籃板球
心系人	心繫人
蜡月	蜡月
鼓噪	鼓譟
聽著者	聽著者
别扭	彆扭
住著	住着
采种	採種
心系黄	心繫黃
结余	結餘
擋著稱	擋著稱
賽普勒斯	塞浦路斯
褒赞	褒讚
瞞著	瞞着
心系五	心繫五
荜	蓽
蒙汜	濛汜
高畫質	高清
台风稳健	台風穩健
捷豹	積架
带征	帶徵
叫著述	叫著述
宇航员	太空人
涂	塗
筑後	筑後
抱著錄	抱著錄
校舍	校舍
淡蒙蒙	淡濛濛
喲喂	喲喂
撼著書	撼著書
范字	範字
分钟里	分鐘裡
涞	淶
尸居余气	尸居餘氣
自制你	自制你
鋪著錄	鋪著錄
复杂	複雜
，个中	，箇中
逦	邐
干苔	乾苔
萊特灣	雷伊泰灣
穑	穡
跪著述	跪著述
茶面	茶麵
干流	幹流
達著者	達著者
亿周后	億周後
心系汶	心繫汶
并曰入淀	並曰入澱
求知欲	求知慾
穷	窮
占百	佔百
注生娘娘	註生娘娘
委托	委託
南宫适	南宮适
主钟曲线	主鐘曲線
語著稱	語著稱
纪	紀
形上學	形而上學
阳谷	陽穀
附著名	附著名
心系江	心繫江
普咚咚	普鼕鼕
于勒	于勒
肉欲	肉慾
懑	懣
低著稱	低著稱
揉著名	揉著名
绿发	綠髮
对表达	對表達
辟土	闢土
于立成	于立成
卤子	滷子
布雷艦	佈雷艦
之余	之餘
只采	只採
余霞	餘霞
杰伦	杰倫
决斗	決鬥
范文程	范文程
遏制	遏制
润	潤
辟地	闢地
丑角	丑角
布雷艇	佈雷艇
发辫	髮辮
基准	基準
猫	貓
猬	蝟
献	獻
对准	對準
坐如钟	坐如鐘
猡	玀
踏著	踏着
摊	攤
弹	彈
所占卜	所占卜
占缺	佔缺
同余	同餘
七余	七餘
網球台	網球台
山里的	山裡的
中型钟表面	中型鐘表面
逾闲	踰閑
猎	獵
瞩托	矚託
朴子里	朴子里
猃	獫
亮著作	亮著作
丑比	醜比
数只可	數只可
斗叶儿	鬥葉兒
猕	獼
彩球	綵球
冲决	衝決
井里	井裡
壹郁	壹鬱
林杰樑	林杰樑
考著稱	考著稱
叫著	叫着
冲冠	衝冠
卤制	滷製
传位于四太子	傳位于四太子
话里有话	話裡有話
埃博拉	伊波拉
㟆	㠏
弪	弳
选	選
文采郁郁	文采郁郁
剪其发	剪其髮
生物钟	生物鐘
多半只	多半只
威棱	威稜
无业游民	無業游民
騎著稱	騎著稱
叶叶琴	葉叶琴
肝郁	肝鬱
闹钟	鬧鐘
夸过	誇過
郁闭	鬱閉
哭著稱	哭著稱
郁闷	鬱悶
公釐	毫米
干大事	幹大事
信著錄	信著錄
袖里	袖裡
爽荡	爽蕩
赢余	贏餘
唾余	唾餘
树干	樹幹
后豐	后豐
风物志	風物誌
弥	彌
兼并	兼併
杜琪峰	杜琪峯
尘	塵
双雕	雙鵰
尔	爾
只身上沒	只身上沒
寻	尋
見著名	見著名
丑头怪脸	醜頭怪臉
将	將
沉著稱	沉著稱
尽	盡
尸	屍
尴	尷
青山一发	青山一髮
园里	園裡
冥蒙	冥濛
游离	游離
卷叶蛾	捲葉蛾
綁著者	綁著者
占掉	佔掉
只身上没	只身上沒
一干人	一干人
共和历史	共和歷史
葫芦里卖甚么药	葫蘆裡賣甚麼藥
奋	奮
有征战	有征戰
用著述	用著述
匪干	匪幹
卡普里亚蒂	卡佩雅蒂
一只	一隻
詩云	詩云
词干	詞幹
受著書	受著書
有征戰	有征戰
准保	準保
屡顾尔仆	屢顧爾僕
看钟	看鐘
斗殴	鬥毆
制作	製作
农历	農曆
捆著述	捆著述
复平面	複平面
游牧	遊牧
占分	佔分
𤽯	㿧
盐余	鹽餘
動著作	動著作
𨐈	輄
下签写	下簽寫
哗	嘩
哕	噦
哔	嗶
哓	嘵
數位技術	數碼技術
哑	啞
解雇	解僱
哟	喲
哝	噥
哜	嚌
試著	試着
哙	噲
搶占	搶佔
占到	佔到
每只	每隻
西谷米	西谷米
响	響
强占	強佔
余九	餘九
丰采	丰采
识	識
順著書	順著書
评	評
诅	詛
拉著書	拉著書
诃	訶
纯朴	純樸
证	證
诎	詘
诏	詔
辟田	闢田
词	詞
诊	診
翻涌	翻湧
诈	詐
诉	訴
𩧰	䮝
愛著者	愛著者
诔	誄
试	試
闵采尔	閔採爾
诓	誆
𩧶	𩣏
译	譯
诞	誕
诟	詬
𩧺	駶
话	話
诚	誠
诛	誅
诘	詰
诙	詼
详	詳
诧	詫
诤	諍
于學忠	于學忠
询	詢
诣	詣
诠	詮
诡	詭
诮	誚
误	誤
诬	誣
语	語
诪	譸
诫	誡
诨	諢
诩	詡
诶	誒
请	請
说	說
诵	誦
诲	誨
诳	誑
诰	誥
诱	誘
课	課
罩著者	罩著者
诼	諑
诽	誹
诺	諾
读	讀
诸	諸
甜著述	甜著述
心系林	心繫林
綁著書	綁著書
大明历史	大明歷史
奥	奧
尸臣	尸臣
愛著書	愛著書
冲来	衝來
每每只	每每只
涂长望	涂長望
征圣	徵聖
夸大	誇大
崑山	崑山
夸夸	誇誇
台式电脑	桌上型電腦
披发	披髮
黄金表	黃金表
占〇	佔〇
对准钟表	對準鐘錶
豎著書	豎著書
临潼斗宝	臨潼鬥寶
阁	閣
努力著称	努力著稱
郊游	郊遊
干的事	幹的事
茕	煢
茔	塋
1天后	1天後
郁血	鬱血
茏	蘢
茎	莖
力拼	力拚
债累累	債纍纍
于冠华	于冠華
建筑前	建築前
蹭棱子	蹭稜子
放荡	放蕩
于孔兼	于孔兼
大伙	大夥
发引千钧	髮引千鈞
中型钟表	中型鐘錶
采茶	採茶
扎起	紮起
游目骋怀	遊目騁懷
字里行间	字裡行間
聽得著	聽得着
茧	繭
遇著稱	遇著稱
沿著者	沿著者
千扎	千紮
丝恩发怨	絲恩髮怨
吊旗	弔旗
党进	党進
钢制	鋼製
杆枪	桿槍
斗心眼	鬥心眼
性征	性徵
鉴赏	鑑賞
北山索面	北山索麵
面店	麵店
烫完发	燙完髮
素数里	素數裡
竹制	竹製
涛	濤
布下了	佈下了
伊里布	伊里布
系怀	繫懷
悬钟	懸鐘
羡余	羨餘
精干	精幹
䌸	縳
划一槳	划一槳
趕著稱	趕著稱
干料	乾料
肴	餚
倒楣	倒霉
管著錄	管著錄
占法	佔法
摆布	擺佈
于和偉	于和偉
尽尽	儘儘
紧	緊
年代里	年代裡
所占	所佔
韩国制	韓國製
飘发自由女神	飄髮自由女神
干茨腊	乾茨臘
死里求生	死裡求生
梦游	夢遊
有著述	有著述
載著稱	載著稱
凱薩琳	嘉芙蓮
抱著稱	抱著稱
1只支援	1只支援
高清愿	高清愿
游春	遊春
栌	櫨
卢棱伽	盧稜伽
于占元	于占元
径行	逕行
對著	對着
趙威后	趙威后
戴著述	戴著述
閑著錄	閑著錄
横	橫
出乖露丑	出乖露醜
著法	着法
循著書	循著書
农民历	農民曆
游星	遊星
智慧手機	智能手機
瑶签	瑤籤
樱	櫻
空中布雷	空中佈雷
准定	準定
竞	競
行家里手	行家裡手
迈克尔·欧文	米高·奧雲
信著作	信著作
余辉	餘輝
郁郁不平	鬱鬱不平
過著作	當著作
干支支	乾支支
乌发	烏髮
潜意识里	潛意識裡
𥆧	瞤
皇后	皇后
跑著者	跑著者
叽	嘰
心著作	心著作
颈	頸
颉	頡
颊	頰
颋	頲
颌	頜
颍	潁
強占	強佔
颏	頦
颀	頎
狄托	鐵托
四舍六入	四捨六入
颃	頏
预	預
颅	顱
领	領
颇	頗
题	題
颙	顒
颚	顎
艳	艷
颜	顏
额	額
颞	顳
颟	顢
颐	頤
椒面	椒麵
颒	頮
颓	頹
颔	頷
颕	頴
颖	穎
颗	顆
采納	採納
春香斗学	春香鬥學
息谷	息穀
駕著名	駕著名
颠	顛
艷后	艷后
颢	顥
颣	纇
浩荡	浩蕩
颥	顬
颦	顰
颧	顴
后发座	后髮座
岽	崬
艺	藝
一发千钧	一髮千鈞
占三	佔三
占下	佔下
占一	佔一
占七	佔七
采石之戰	采石之戰
占万	佔萬
酿	釀
大笨钟	大笨鐘
占东	佔東
棱子	稜子
衝著	衝着
雅著	雅着
亮丑	亮醜
宣泄	宣洩
占个	佔個
钟匠	鐘匠
占中	佔中
占两	佔兩
酾	釃
首当其冲	首當其衝
口干犯	口干犯
占为	佔為
占主	佔主
扛著稱	扛著稱
含著名	含著名
秃发	禿髮
丑女	醜女
伡	俥
秤杆	秤桿
2天后	2天後
罗马历	羅馬曆
流著者	流著者
仗著者	仗著者
嫔	嬪
嫒	嬡
余光生	余光生
干湿	乾濕
风后，	風後，
防范	防範
自制一下	自制一下
手里	手裡
核准	核准
自制的能	自制的能
吊祭	弔祭
那只用	那只用
干面	乾麵
咸派	鹹派
提摩太后书	提摩太後書
园游会	園遊會
发脚	髮腳
凶嫌	兇嫌
心系女	心繫女
竖起脊梁	豎起脊梁
疏松	疏鬆
心系舞	心繫舞
云笈七签	雲笈七籤
不克自制	不克自制
9只	9隻
永历	永曆
捉发	捉髮
網際網路	互聯網
厢	廂
黄发	黃髮
厦	廈
厨	廚
厩	廄
歲聿云暮	歲聿云暮
樂著	樂着
电子表格	電子表格
余五	餘五
狱里	獄裡
繞著	繞着
自制我	自制我
回路	迴路
县	縣
著祂	着祂
厂	廠
厅	廳
历	歷
余事	餘事
厉	厲
只采声	只采聲
压	壓
厌	厭
厍	厙
不太准	不太準
厐	龎
厕	廁
丑徒	醜徒
干暖	乾暖
喽	嘍
余二	餘二
姜末	薑末
沖著《	沖著《
畅游	暢遊
浅淀	淺澱
沖著。	沖著。
干燥	乾燥
藏著書	藏著書
乌龙面	烏龍麵
演著錄	演著錄
著我	着我
記著	記着
封為后	封為后
心系宣	心繫宣
埙	塤
惊钟	驚鐘
好丑	好醜
握发	握髮
大只会	大只會
藏著稱	藏著稱
干草	乾草
配著書	配著書
漫著名	漫著名
百只	百隻
复句	複句
面坊	麵坊
俩	倆
复叶	複葉
真丑	真醜
大只有	大只有
殿里	殿裡
沉郁	沉鬱
烘干	烘乾
慣著名	慣著名
尽速	儘速
味著	味着
潤著錄	潤著錄
紧追不舍	緊追不捨
机械钟表	機械鐘錶
有只容	有只容
自干五	自乾五
见棱见角	見稜見角
甜著	甜着
衔	銜
立著有	立著有
衬	襯
皇极历史	皇極歷史
衮	袞
賭后	賭后
谷子	穀子
占高枝儿	佔高枝兒
补	補
跳著名	跳著名
尸位素餐	尸位素餐
候著書	候著書
夾著	夾着
坦尚尼亞	坦桑尼亞
准线	準線
松快	鬆快
過著錄	當著錄
向往	嚮往
戈巴契夫	戈爾巴喬夫
能干	能幹
上梁山	上梁山
單向	單向
多只用	多只用
去山里	去山裡
荞麦面	蕎麥麵
追著作	追著作
抵触	牴觸
赞赏	讚賞
變著述	變著述
挽曲	輓曲
歐巴馬	奧巴馬
丑陋	醜陋
创制	創製
猜著名	猜著名
尋著稱	尋著稱
现	現
玱	瑲
折叠	摺疊
玺	璽
靠著錄	靠著錄
困乏	睏乏
醯壺	醯壺
順著稱	順著稱
艳后	艷后
占线	佔線
丑死	醜死
科尼亚克期	科尼亞克期
醯壶	醯壺
环	環
閑著述	閑著述
玑	璣
周历	周曆
拼舍	拚捨
玚	瑒
玛	瑪
余零	餘零
玙	璵
𪎈	䴬
𪎉	麲
打卤	打滷
𪎋	䴴
一周后	一周後
荫	蔭
5只支持	5只支持
膨松	膨鬆
干干	乾乾
于志寧	于志寧
圈梁	圈樑
发饰	髮飾
水准	水準
击钟	擊鐘
悠著錄	悠著錄
打卡钟	打卡鐘
蜕	蛻
新井里美	新井里美
沉著作	沉著作
丑言	醜言
吊取	弔取
下注解	下注解
酒曲	酒麴
吉征	吉徵
穆罕默德历	穆罕默德曆
動著錄	動著錄
提子干	提子乾
数只限	數只限
艾滋	愛滋
流著名	流著名
心里面	心裏面
背著作	背著作
家丑	家醜
骨灰坛	骨灰罈
借著述	借著述
心系昌	心繫昌
天台	天台
䍀	繿
䍁	繸
佣錢	佣錢
卤豆	滷豆
記著稱	記著稱
冬山庄	冬山庄
喜欢钟表	喜歡鐘錶
克期	剋期
于贈	于贈
殓	殮
殒	殞
行著述	行著述
殚	殫
殇	殤
心系日	心繫日
山仔后	山仔后
裁制	裁製
殁	歿
残	殘
殴	毆
1只	1隻
蛊	蠱
堕	墮
殡	殯
載著	載着
采选	採選
发根	髮根
啮合	嚙合
制件	製件
罚	罰
得著書	得著書
手表示	手表示
据云	據云
醋坛	醋罈
夸特	夸特
蘸著作	蘸著作
将占卜	將占卜
拉著	拉着
游骑兵	遊騎兵
姓么	姓么
优	優
阁府	閤府
了望	瞭望
数罪并罚	數罪併罰
神荼郁垒	神荼鬱壘
放著称	放著稱
叫著名	叫著名
北回铁路	北迴鐵路
防御	防禦
干梅	乾梅
起哄	起鬨
余力為	余力為
捶炼	捶鍊
里海茨	里海茨
衣著述	衣著述
店里	店裡
南宮适	南宮适
夾著述	夾著述
呙	咼
斗犀台	鬥犀臺
呛	嗆
奸杀	姦殺
巴尔米拉环礁	帕邁拉環礁
呐	吶
潜水钟	潛水鐘
占加	佔加
呕	嘔
呗	唄
呖	嚦
高著	高着
卷图	捲圖
晒谷	曬穀
单打独斗	單打獨鬥
这只能	這只能
筑紫	筑紫
凶枪	兇槍
遇著作	遇著作
神游	神遊
干嘛	幹嘛
岳岳	嶽嶽
用著	用着
努力著錄	努力著錄
南屏晚钟	南屏晚鐘
科范	科範
走著述	走著述
么喝	么喝
争妍斗艳	爭妍鬥豔
台子女	台子女
桌历	桌曆
斗勇	鬥勇
磽确	磽确
订	訂
于阗	于闐
開著名	開著名
惯	慣
丑声	醜聲
折裙	摺裙
更签	更籤
原钟	原鐘
急著	急着
來著錄	來著錄
殴斗	毆鬥
划來划去	划來划去
婳	嫿
金发	金髮
婴	嬰
占所有	佔所有
愛荷華	艾奧瓦
備著者	備著者
舍堕	捨墮
并力	併力
轫	軔
折冲	折衝
贻范	貽範
昽	曨
占美国	佔美國
迥然回异	迥然迴異
讧	訌
急著錄	急著錄
布什	布殊
6只支援	6只支援
授时历	授時曆
莱	萊
莳	蒔
莲	蓮
于逸堯	于逸堯
莴	萵
素发	素髮
莶	薟
莹	瑩
莸	蕕
莺	鶯
高后	高后
看著者	看著者
温洛克期	溫洛克期
讦	訐
莅	蒞
上签署	上簽署
三扎	三紮
原子钟	原子鐘
抓奸	抓姦
熏陶	薰陶
苦著述	苦著述
托克逊	託克遜
0只支持	0只支持
3余	3餘
陋著錄	陋著錄
吹发	吹髮
赠	贈
游踪	遊蹤
丰儀	丰儀
布雷封锁	佈雷封鎖
宫里	宮裡
对表现	對表現
获匪其丑	獲匪其醜
紀錄著	紀錄着
附著作	附著作
慣著	慣着
游逛	遊逛
伊于湖底	伊于湖底
忠貞著	忠貞着
鬥著名	鬥著名
宫	宮
說著述	說著述
铜制	銅製
面厂	麵廠
燒著述	燒著述
倚闲	倚閑
怒火冲天	怒火衝天
骚	騷
那只可	那只可
當著作	當著作
獲著名	獲著名
蘸著錄	蘸著錄
雕悍	鵰悍
棱等登	稜等登
你夸	你誇
占头筹	佔頭籌
𨰾	鎷
𨰿	釳
附著稱	附著稱
住著錄	住著錄
撤并	撤併
准新郎	準新郎
關著者	關著者
有准	有準
括发	括髮
挑著稱	挑著稱
閉著	閉着
丰姿	丰姿
讬	託
荡来荡去	蕩來蕩去
惴栗	惴慄
有征伐	有征伐
党姓	党姓
發著稱	發著稱
调钟表	調鐘錶
茅于轼	茅于軾
干菜	乾菜
千只足够	千只足夠
困著書	困著書
须须	鬚鬚
棱棱	稜稜
金链	金鍊
复印	複印
索馬里	索馬里
伴著者	伴著者
視著稱	視著稱
得力干将	得力幹將
编制法	編制法
殺著作	殺著作
坐著錄	坐著錄
畴	疇
聽著書	聽著書
多只在	多只在
术虎高	朮虎高
荡女	蕩女
朱砂	硃砂
译文里	譯文裡
心系浙	心繫浙
畅	暢
扛著書	扛著書
棱线	稜線
回历	回曆
回光返照	迴光返照
占畢	佔畢
九只	九隻
拨	撥
里氏规模	黎克特制震級
4只	4隻
庙里	廟裡
拢	攏
拣	揀
称赞	稱讚
拥	擁
拦	攔
借资	藉資
弥漫	瀰漫
干唱	乾唱
𢋈	㢝
隱几	隱几
纬	緯
汇刊	彙刊
痒痒	痒痒
钟被	鐘被
担	擔
仆僮	僕僮
超赞	超讚
空著述	空著述
將占卜	將占卜
罵著名	罵著名
仲裁制	仲裁制
心余	心餘
爷	爺
那只	那隻
脊梁背	脊梁背
埔里社	埔裏社
姜老辣	薑老辣
黄诗杰	黃詩杰
占總	佔總
名单于	名單於
零天后	零天後
手表态	手表態
台面化	檯面化
十扎	十紮
走著名	走著名
戀著者	戀著者
梁上	樑上
讵	詎
宽余	寬餘
划一桨	划一槳
只身首	只身首
𥧂	𥨐
兀术	兀朮
占过	佔過
三十六著	三十六着
铁锈	鐵鏽
悠著	悠着
喀拉蚩	卡拉奇
纫	紉
候著稱	候著稱
秀发起	秀發起
蓄须	蓄鬚
数只比	數只比
古书云	古書云
干巴	乾巴
千余	千餘
郧	鄖
郦	酈
頂著名	頂著名
郸	鄲
𫂈	䉬
乐游原	樂遊原
证谏	証諫
泞	濘
谷场	穀場
郏	郟
扛著	扛着
泪	淚
腐干	腐乾
游园	遊園
松柔	鬆柔
泶	澩
泷	瀧
泸	瀘
睡著	睡着
泺	濼
泻	瀉
泼	潑
泽	澤
泾	涇
獲著稱	獲著稱
丰茸	丰茸
犹如钟表	猶如鐘錶
心系生	心繫生
多只包括	多只包括
显示表头	顯示表頭
遍布著	遍佈着
見著書	見著書
精制服	精制服
干村沙	乾村沙
占屋	佔屋
𩐀	䪗
揽	攬
侥幸	僥倖
揾	搵
凶殘	兇殘
代理发行	代理發行
匮	匱
心系困	心繫困
发乳	髮乳
心系国	心繫國
匦	匭
区	區
医	醫
妖气冲天	妖氣衝天
凶残	兇殘
历命	曆命
箫	簫
留发展	留發展
箨	籜
蒙昧无知	矇昧無知
凶殺	兇殺
船只能	船只能
明范	明範
匀	勻
码表	碼錶
心系四	心繫四
纥	紇
下著	下着
赞词	讚詞
拿著稱	拿著稱
假托	假託
武丑	武丑
理一次发	理一次髮
冲出	衝出
一干二净	一乾二淨
累臣	纍臣
頂多	頂多
凤梨干	鳳梨乾
變著書	變著書
只占算	只占算
亮著名	亮著名
見著錄	見著錄
干群关系	幹群關係
背著錄	背著錄
旧钟	舊鐘
喜欢表	喜歡錶
庫德族	庫爾德族
夹衣	袷衣
限制	限制
美著作	美著作
耀著書	耀著書
冲头阵	衝頭陣
调表	調錶
通心面	通心麵
古文里	古文裡
满拼自尽	滿拚自盡
尽其所有	儘其所有
电子制表	電子製表
照著名	照著名
俯卧撑	掌上壓
五只	五隻
制著	制着
舍身	捨身
系上红	繫上紅
跳梁小丑	跳樑小丑
凶惡	兇惡
豎著作	豎著作
赵威后	趙威后
幹著	幹着
掖著	掖着
干校	幹校
樗里子	樗里子
望著書	望著書
卢塞恩	琉森
留著稱	留著稱
骎	駸
只手遮天	隻手遮天
并肩子	併肩子
為著稱	為著稱
跪著書	跪著書
回荡	迴蕩
手游	手遊
寶曆	寶曆
下梁	下樑
致密	緻密
屋里	屋裡
钻	鑽
裆	襠
装	裝
裈	褌
半只够	半只夠
凶险	兇險
斗士	鬥士
𥭉	𥵊
盏	盞
瞳蒙	瞳矇
钿	鈿
裢	褳
裣	襝
太丑	太醜
裡	裏
裤	褲
裥	襉
落著	落着
散荡	散蕩
赞扬	讚揚
𦰴	䕳
晃著作	晃著作
𡭜	𡮉
采得	採得
征吏	徵吏
福著名	福著名
征实	徵實
丑媳妇	醜媳婦
于樹潔	于樹潔
钨	鎢
走著錄	走著錄
干吗	幹嗎
雪里	雪裡
药	藥
自制能力	自制能力
征启	徵啟
钫	鈁
笋干	筍乾
守著称	守著稱
数只在	數只在
漓湘	灕湘
照著錄	照著錄
耢	耮
稽征	稽徵
寫著稱	寫著稱
透辟	透闢
耻	恥
據著者	據著者
耸	聳
盐	鹽
于廣洲	于廣洲
为鉴	為鑑
鹤峰县	鶴峯縣
2余	2餘
复阅	複閱
炖	燉
雇主	僱主
盧安達	盧旺達
转托	轉託
钦	欽
钧	鈞
托管国	托管國
壓著名	壓著名
汇辑	彙輯
合历	合曆
信著	信着
學著述	學著述
划進	划進
涼著稱	涼著稱
轉著述	轉著述
文丑	文丑
汇纂	彙纂
連著者	連著者
于寘	于寘
彩衣	綵衣
中境里	中境里
跪著	跪着
艾里爾·夏隆	阿里埃勒·沙龍
配制	配製
鳥栖	鳥栖
干馆	乾館
钐	釤
棱登	稜登
耀著錄	耀著錄
晨钟	晨鐘
钑	鈒
行事历史	行事歷史
干霍乱	乾霍亂
溢著名	溢著名
丑妇	醜婦
占毕	佔畢
占比	佔比
白皮松	白皮松
膠著錄	膠著錄
所有只	所有只
扎下	紮下
扎上	紮上
數著名	數著名
寫著名	寫著名
下签了	下簽了
针	針
选手表达	選手表達
海干	海乾
纏著者	纏著者
钉	釘
心系德	心繫德
嚷著書	嚷著書
尽可能	儘可能
光著作	光著作
䦃	鐯
雇工	僱工
䏝	膞
摭采	摭採
于越	于越
饥饱	饑飽
試著者	試著者
休征	休徵
制造	製造
黄	黃
黉	黌
迷蒙	迷濛
洒淅	洒淅
十个	十個
視著	視着
字码表	字碼表
郁卒	鬱卒
郁南	鬱南
正官庄	正官庄
占耕	佔耕
府干卿	府干卿
黡	黶
庄司	庄司
黪	黲
黩	黷
做著稱	做著稱
留著名	留著名
沈河	瀋河
钅	釒
面饼	麵餅
面饺	麵餃
舞后	舞后
愛著錄	愛著錄
欧	歐
·威爾士	·威爾士
干个	幹個
伊斯蘭瑪巴德	伊斯蘭堡
壓著錄	壓著錄
石英钟表	石英鐘錶
領著錄	領著錄
痫	癇
痪	瘓
望著述	望著述
視著名	視著名
卤菜	滷菜
痳	痲
系于一发	繫於一髮
求签	求籤
吃得著	吃得着
痉	痙
痈	癰
芸薹	蕓薹
痖	瘂
著腳	着腳
隔著述	隔著述
矜夸	矜誇
福著述	福著述
馔	饌
御岳山	御嶽山
扰	擾
馐	饈
馑	饉
馒	饅
鉴	鑒
于振	于振
数字信号	數碼訊號
馄	餛
盛著述	盛著述
馆	館
馇	餷
馀	餘
执	執
馂	餕
馃	餜
制革	製革
池里	池裡
馎	餺
扩	擴
馈	饋
馉	餶
扬	揚
馋	饞
扑	撲
帘子	帘子
鸟栖市	鳥栖市
7余	7餘
著她	着她
偷著述	偷著述
卤鸭	滷鴨
豎著述	豎著述
跳荡	跳蕩
抱著作	抱著作
卤鸡	滷雞
游冶	遊冶
雕心雁爪	鵰心雁爪
课征	課徵
占优	佔優
征象	徵象
仆少	僕少
雕翎	鵰翎
穆棱	穆稜
斗兽	鬥獸
新历	新曆
咸猪	鹹豬
戀著錄	戀著錄
里瓦尔多	李華度
逆风后	逆風後
拎著稱	拎著稱
朝鲜于	朝鮮於
推情准理	推情準理
涌向	湧向
漕挽	漕輓
划到岸	划到岸
的回复	的回覆
㤘	㥮
含著稱	含著稱
拔发	拔髮
尸棄佛	尸棄佛
4天后	4天後
发布	發佈
姗	姍
望著錄	望著錄
咬姜呷醋	咬薑呷醋
栖栖皇皇	栖栖皇皇
上课钟	上課鐘
姹	奼
’	』
‘	『
六周后	六周後
李志喜	李志喜
“	「
发带	髮帶
舍实	捨實
打著作	打著作
行動網路	流動網絡
嚷著錄	嚷著錄
托疾	託疾
後庄	後庄
水表面	水表面
里氏0	黎克特制0
德勒斯登	德累斯頓
南京钟表	南京鐘錶
戛纳	康城
胡梢	鬍梢
精辟	精闢
卷心菜	捲心菜
夸赞	誇讚
一出悲剧	一齣悲劇
腑脏	腑臟
复本	複本
万签插架	萬籤插架
四分历史	四分歷史
钟声	鐘聲
拉面罩	拉面罩
大只是	大只是
達著稱	達著稱
后安路	后安路
敞著者	敞著者
依依不舍	依依不捨
斗彩	鬥彩
好勇斗狠	好勇鬥狠
钟壁	鐘壁
西臺族	赫梯族
拼却	拚卻
單于	單于
累瓦结绳	纍瓦結繩
寄托	寄託
十出击	十出擊
动	動
嗅著	嗅着
凶横	兇橫
务	務
劢	勱
势	勢
拉克施尔德钟	拉克施爾德鐘
干枯	乾枯
劲	勁
辦著稱	辦著稱
照著者	照著者
宽松松	寬鬆鬆
本著書	本著書
踩著	踩着
白面包青天	白面包青天
舰只	艦隻
干果	乾果
撄	攖
劝	勸
晃荡	晃蕩
批准确定	批准確定
引斗	引鬥
复评	複評
布雷的	佈雷的
肝脏	肝臟
病征	病徵
复词	複詞
后座	后座
复诊	複診
馬里蘭	馬利蘭
新干县	新幹縣
复试	複試
有只允	有只允
克薄	剋薄
0只	0隻
小只在	小只在
陈有后	陳有后
乘著述	乘著述
保障著作	保障著作
甜著書	甜著書
住著者	住著者
五余	五餘
踬	躓
独裁制	獨裁制
取舍	取捨
饥民	饑民
數據機	調制解調器
复课	複課
吊民	弔民
系到	繫到
游学	遊學
不负所托	不負所托
榴蓮	榴槤
影后	影后
修杰楷	修杰楷
棉制	棉製
准话	準話
搏斗	搏鬥
行著	行着
跪著錄	跪著錄
高著者	高著者
面包扎	面包紮
蒙混	矇混
余声	餘聲
残肴	殘肴
包准	包準
配合著	配合着
历史里	歷史裡
低著名	低著名
苍郁	蒼鬱
寮語	老撾語
占主要	佔主要
舍己从人	捨己從人
梯冲	梯衝
卷风	捲風
枕著	枕着
钟点	鐘點
荡涤	蕩滌
血拼	血拚
松溪县	松谿縣
斗成	鬥成
于雲鶴	于雲鶴
额我略历	額我略曆
萤	螢
凶巴巴	兇巴巴
能干扰	能干擾
游宦	遊宦
复比	複比
夸得	誇得
制版	製版
盘	盤
斗战	鬥戰
仗著作	仗著作
分钟	分鐘
有只不	有只不
壓著者	壓著者
丑巴怪	醜巴怪
征咎	徵咎
郁纡	鬱紆
行著名	行著名
钟体	鐘體
矛盾著	矛盾着
县志	縣誌
犸	獁
型范	型範
状	狀
犷	獷
干粉	乾粉
空荡荡	空蕩蕩
占網	佔網
云云	云云
角落发	角落發
拼著者	拼著者
對著書	對著書
那卷	那捲
撼著錄	撼著錄
铁钟	鐵鐘
大只可	大只可
干粮	乾糧
宇宙志	宇宙誌
金表露	金表露
余威	餘威
厘清	釐清
谷神	穀神
照著稱	照著稱
寮國	老撾
叶不二子	叶不二子
汉	漢
遥	遙
甜面酱	甜麵醬
辟建	闢建
汇	匯
二周后	二周後
刻多钟	刻多鐘
汙	污
含著者	含著者
二天后	二天後
教范	教範
范文澜	范文瀾
半只可	半只可
𫄸	纁
鸬	鸕
生姜	生薑
抓斗	抓鬥
范文芳	范文芳
乱哄哄	亂鬨鬨
汤	湯
𫄨	絺
所占算	所占算
党项	党項
户	戶
鸠	鳩
昂著作	昂著作
著迷	着迷
蘖	櫱
存著	存着
非占不可	非佔不可
䉤	籔
粜	糶
只身為	只身為
于谨	于謹
候著者	候著者
点赞	點讚
毗婆尸佛	毗婆尸佛
斗着	鬥着
膠著書	膠著書
于忠肃集	于忠肅集
猜著書	猜著書
秀发展	秀發展
监	監
个月里	個月裡
齿发	齒髮
有著書	有著書
征迹	徵跡
历尾	曆尾
跪著者	跪著者
高著錄	高著錄
于双戈	于雙戈
家伙	傢伙
粪	糞
小井里	小井里
鸿	鴻
鹅	鵝
游方	遊方
鹇	鷳
用著錄	用著錄
簡筑翎	簡筑翎
游廊	遊廊
鹃	鵑
鹂	鸝
鹍	鵾
鹌	鵪
鹏	鵬
鸽	鴿
鹉	鵡
檩	檁
鹋	鶓
鹊	鵲
十出頭	十出頭
挑斗	挑鬥
鹗	鶚
鹖	鶡
鹑	鶉
鹐	鵮
鹓	鵷
鹒	鶊
鹝	鷊
鹜	鶩
鹟	鶲
鹞	鷂
连采	連採
鹘	鶻
鹛	鶥
鹚	鶿
鹥	鷖
鹤	鶴
鹧	鷓
鹦	鸚
鹡	鶺
心系天	心繫天
鹣	鶼
鹢	鷁
鹭	鷺
鹬	鷸
鹯	鸇
发签	發籤
沈水	瀋水
余音	餘音
鹫	鷲
鹪	鷦
柳斌杰	柳斌杰
樂著名	樂著名
南朝鲜	南韓
鹱	鸌
拖著者	拖著者
质数里	質數裡
浮著者	浮著者
鹾	鹺
两出	兩齣
據著錄	據著錄
小只是	小只是
东岳	東嶽
遮丑	遮醜
斗牙斗齿	鬥牙鬥齒
精致	精緻
托词	託詞
連著名	連著名
高干扰	高干擾
夹裙	袷裙
子里	子裡
打著錄	打著錄
蒙胧	朦朧
怀钟	懷鐘
員山庄	員山庄
五脏	五臟
遇著	遇着
爭著者	爭著者
必须	必須
醯鸡	醯雞
壓著稱	壓著稱
后庄	后庄
游河	遊河
能干涉	能干涉
占著者	佔著者
于貝爾	于貝爾
观采	觀採
窒欲	窒慾
只身上无	只身上無
刹	剎
图鉴	圖鑑
发菜	髮菜
膠著名	膠著名
须毛	鬚毛
拔须	拔鬚
好斗膽	好斗膽
黑干将	黑幹將
有著稱	有著稱
系风捕影	繫風捕影
猜著稱	猜著稱
购并	購併
福著者	福著者
面汤	麵湯
征才	徵才
曰云	曰云
山里有	山裡有
假发	假髮
出乖弄丑	出乖弄醜
嘴里	嘴裡
于光遠	于光遠
坛子	罈子
于是之	于是之
实累累	實纍纍
霉毒	黴毒
洛钟东应	洛鐘東應
荷花淀	荷花澱
会占卜	會占卜
千只可	千只可
渴著述	渴著述
赶制	趕製
醯雞	醯雞
采石磯	采石磯
泡面	泡麵
千里達托貝哥	特立尼達和多巴哥
于禁	于禁
辟佛	闢佛
辟作	闢作
前波莫瑞	前波美拉尼亞
征稿	徵稿
奖	獎
跟著書	跟著書
磨蝎	磨蝎
拿著作	拿著作
奁	奩
崑调	崑調
智慧卡	智能卡
征逐	徵逐
茅利塔尼亞	毛里塔尼亞
鬥著述	鬥著述
献丑	獻醜
卷帘	捲簾
征选	徵選
征税	徵稅
關著述	關著述
肮	骯
径庭	逕庭
黃杰	黃杰
肤	膚
圈占	圈佔
肠	腸
肿	腫
肾	腎
瓜地馬拉	危地馬拉
戲院里	戲院里
挑著	挑着
采暖	採暖
定准	定準
缝里	縫裡
肃	肅
志哀	誌哀
范金	範金
斗弄	鬥弄
吊钟	吊鐘
扎诈	紮詐
㖞	喎
编余	編餘
南筑	南筑
后发星系团	后髮星系團
尸子	尸子
丁丁当当	丁丁當當
个里	個裡
范数	範數
趱干	趲幹
渖	瀋
百科里	百科裡
择日占星	擇日占星
咕咕钟	咕咕鐘
趴著述	趴著述
晓	曉
飘荡	飄蕩
贵征	貴徵
借此	藉此
土制	土製
制冷机	制冷機
趸	躉
交哄	交鬨
折台	摺檯
躏	躪
会里	會裡
淳于	淳于
拼著稱	拼著稱
躜	躦
划得來	划得來
鬥著稱	鬥著稱
芮氏地震規模	黎克特制地震震級
郁燠	鬱燠
词汇	詞彙
皺著者	皺著者
應著錄	應著錄
抱朴而长吟兮	抱朴而長吟兮
大本钟	大本鐘
躯	軀
万历史	萬歷史
占局部	佔局部
定著述	定著述
斗舰	鬥艦
捍御	捍禦
涌进	湧進
胡髯	鬍髯
胡髭	鬍髭
壮面	壯麵
撞球	桌球
连三并四	連三併四
立著者	立著者
显示钟	顯示鐘
郁泱	鬱泱
宿舍	宿舍
0出现	0出現
下著有	下著有
老板	老闆
悲凄	悲悽
昆嵛	崑嵛
托付	託付
个中滋味	箇中滋味
旋松	旋鬆
于和伟	于和偉
炼气	鍊氣
翻松	翻鬆
胪	臚
啬	嗇
许愿起经	許愿起經
挡	擋
散佈著	散佈着
亿余	億餘
候著作	候著作
瑸	璸
瑷	璦
瑶	瑤
表王	錶王
黾	黽
牵一发	牽一髮
准备	準備
雾	霧
謷丑	謷醜
表停	錶停
中签约	中簽約
锈蚀	鏽蝕
采空采穗	採空採穗
于美人	于美人
刮大风	颳大風
乘著錄	乘著錄
捵面	捵麵
复穗	複穗
奧占	奧佔
回文结构	迴文結構
心系湖	心繫湖
卤好	滷好
烧干	燒乾
躁郁	躁鬱
干吏	幹吏
挟	挾
钟表慢	鐘錶慢
卖断发	賣斷發
走回路	走回路
罵著書	罵著書
筵几	筵几
烫一个发	燙一個髮
三天后	三天後
划不來	划不來
货	貨
紅后假說	紅后假說
炖制	燉製
选手表示	選手表示
规范	規範
為著錄	為著錄
麻将席	麻將蓆
余项	餘項
丰標不凡	丰標不凡
姜桂	薑桂
䦅	鐥
䦁	𨧜
䦀	𨦫
罵著稱	罵著稱
䦂	䥇
发上冲冠	髮上沖冠
生锈	生鏽
掖著者	掖著者
冰山里	冰山裡
䦷	䦟
䦶	䦛
卷缩	捲縮
系数	係數
云为	云為
手表演	手表演
干缺	幹缺
管著述	管著述
忙著稱	忙著稱
合并	合併
托过	託過
附著書	附著書
干剥剥	乾剝剝
候著名	候著名
恶心	噁心
发松	發鬆
點著者	點著者
非常准	非常準
牽著書	牽著書
贷	貸
寫著錄	寫著錄
幫著	幫着
落著者	落著者
发状	髮狀
贴	貼
沙琅	沙瑯
贳	貰
释	釋
贲	賁
震栗	震慄
于鬯	于鬯
草席	草蓆
系为	係為
吟游	吟遊
斗志	鬥志
贻	貽
下签收	下簽收
的图里	的圖裡
只身影	只身影
明窗净几	明窗淨几
大只能	大只能
裡冷	裡冷
污蔑	污衊
钟塔	鐘塔
映著書	映著書
红钟	紅鐘
心脏痳痹	心臟痲痺
沉淀	沉澱
刾	㓨
刿	劌
刽	劊
水里溪	水里溪
霉气冲天	霉氣衝天
告里	告裡
手表现	手表現
與著作	與著作
删	刪
據著作	據著作
发短心长	髮短心長
刬	剗
刭	剄
从仆	從僕
别	別
从里到外	從裡到外
划	劃
雅著稱	雅著稱
系膜	繫膜
刚	剛
创	創
刘	劉
布展	佈展
黑发	黑髮
卫星钟	衛星鐘
覆著	覆着
了然后	了然後
布局	佈局
刍	芻
泱郁	泱鬱
駕著錄	駕著錄
繞著者	繞著者
苧烯	薴烯
其次辟地	其次辟地
凭准	憑準
㖊	噚
犹如钟	猶如鐘
表面包	表面包
朴重	樸重
朴野	樸野
寫著作	寫著作
閑著名	閑著名
于韋斯屈萊	于韋斯屈萊
德占	德佔
丑语	醜語
揩干	揩乾
留著述	留著述
干冷	乾冷
欧游	歐遊
遗	遺
争妍斗奇	爭妍鬥奇
关系	關係
穿著述	穿著述
蒙聩	矇聵
干冰	乾冰
斯蒂芬·斯皮尔伯格	史提芬·史匹堡
铽	鋱
捆著稱	捆著稱
觞	觴
走著書	走著書
厘整	釐整
觐	覲
觑	覷
觎	覦
觏	覯
鞋里	鞋裡
觍	覥
觊	覬
觋	覡
𨑹	䢨
觉	覺
视	視
觇	覘
靠著述	靠著述
觅	覓
观	觀
觃	覎
分辨率	解像度
称	稱
味著者	味著者
准保护	准保護
数字钟	數字鐘
苦著書	苦著書
涂醒哲	涂醒哲
干干净净	乾乾淨淨
只身边	只身邊
卷须	卷鬚
觯	觶
于吉	于吉
勾心斗角	勾心鬥角
触	觸
學著稱	學著稱
冒著稱	冒著稱
口干政	口干政
炮制	炮製
干式	乾式
鋪著述	鋪著述
秾	穠
夸张	誇張
風后	風后
鉴戒	鑑戒
崑剧	崑劇
荡荡	蕩蕩
能干休	能干休
撑	撐
試著作	試著作
谷壳	穀殼
打著者	打著者
落著書	落著書
汤下面	湯下麵
回文数	迴文數
醜著作	醜著作
揪采	揪採
踩著書	踩著書
强制作用	強制作用
胜键	胜鍵
花菴词选	花菴詞選
脶	腡
施舍之道	施舍之道
落著稱	落著稱
采收	採收
数只含	數只含
结扎	結紮
梳著者	梳著者
𣎑	臗
斗趣	鬥趣
测不准	測不準
弘历史	弘歷史
特制止	特制止
积	積
向迩	嚮邇
于震	于震
风范	風範
脓	膿
脑	腦
占亿	佔億
好家伙	好傢夥
干性	乾性
脚	腳
佣金	佣金
表带	錶帶
轩辟	軒闢
掙著名	掙著名
六扎	六紮
脍	膾
脾脏	脾臟
被废后	被廢後
脉	脈
周惠后	周惠后
发状态	發狀態
余切	餘切
𠉂	㒓
余刃	餘刃
只影响	只影響
敌忾同仇	敵愾同讎
云须	雲鬚
归并	歸併
高度自制	高度自制
𠉗	𠏢
夜里	夜裡
历纪	曆紀
觌	覿
朱理安历史	朱理安歷史
先采	先採
制贩	製販
為著名	為著名
手链	手鍊
缘	緣
缙	縉
缚	縛
缛	縟
缜	縝
漫著錄	漫著錄
缞	縗
缟	縞
缐	線
缑	緱
缒	縋
踏著者	踏著者
缔	締
缕	縷
编	編
缗	緡
缈	緲
缉	緝
缊	縕
缋	繢
缌	緦
缍	綞
缎	緞
缏	緶
缀	綴
缁	緇
缂	緙
缃	緗
缄	緘
规	規
缆	纜
表里	表裏
闲游	閒遊
并案	併案
演著作	演著作
家里	家裡
領著作	領著作
缰	韁
缱	繾
缲	繰
缳	繯
缴	繳
缵	纘
缨	纓
缩	縮
缪	繆
秆	稈
缬	纈
岩松了	岩松了
缮	繕
缯	繒
缠	纏
缡	縭
缢	縊
见	見
缤	繽
缥	縹
缦	縵
缧	縲
崖广	崖广
松土	鬆土
回历史	回歷史
愿樸	愿樸
荐饥	荐饑
不斗胆	不斗膽
携	攜
搅	攪
于田	于田
面店铺	面店鋪
搁	擱
合历史	合歷史
嫌好道丑	嫌好道醜
使其斗	使其鬥
荐饑	荐饑
揮著述	揮著述
年谷	年穀
详征博引	詳徵博引
棱缝	稜縫
抬著錄	抬著錄
戈登·布朗	白高敦
穿著書	穿著書
眼眶里	眼眶裡
内面包	內面包
瓯	甌
鉴古	鑑古
瓒	瓚
准平原	準平原
盖	蓋
依托	依託
存著名	存著名
颤栗	顫慄
照著	照着
别气	彆氣
水里濁水溪	水里濁水溪
循著述	循著述
丝制	絲製
计	計
膠著稱	膠著稱
占平均	佔平均
夏游	夏遊
委托书	委託書
讣	訃
占零	佔零
躍著	躍着
据	據
对准钟	對準鐘
落著作	落著作
隶	隸
盐打怎么咸	鹽打怎麼鹹
上签	上籤
讥	譏
應著	應着
这出现	這出現
难	難
认	認
捞	撈
损	損
捝	挩
𩠃	𩛩
響著錄	響著錄
日里	日裡
随	隨
隐	隱
余江	餘江
打斗	打鬥
钟速	鐘速
讨	討
年里	年裡
阴干	陰乾
𩠏	𩞦
讪	訕
計畫	計劃
训	訓
西历	西曆
朴父	樸父
只占	只佔
签条	籤條
讯	訊
𩠊	𩜵
公寓里弄	公寓里弄
毕生发展	畢生發展
覆蓋著	覆蓋着
讲	講
懷著名	懷著名
托命	託命
人数只	人數只
里海大学	里海大學
拼老命	拚老命
寡占	寡佔
顺钟向	順鐘向
沥干	瀝乾
馬自達	萬事得
壮	壯
讶	訝
业余	業餘
懔栗	懍慄
口钟	口鐘
城里	城裡
湊合著	湊合着
发式	髮式
壳	殼
夸能斗智	誇能鬥智
横征暴敛	橫徵暴斂
扫荡	掃蕩
壸	壼
钟罩	鐘罩
演著	演着
台灯	檯燈
譯文里	譯文裏
二只得	二只得
干眼	乾眼
古柯鹼	可卡因
注释	注釋
卤汁	滷汁
古語云	古語云
注里	註裡
林钟	林鐘
涸干	涸乾
吹著者	吹著者
神雕	神鵰
㳡	濄
低著作	低著作
才干休	才干休
庑	廡
立著稱	立著稱
枕著名	枕著名
准头	準頭
伴著名	伴著名
库	庫
龙须	龍鬚
手里剑	手裏劍
么二三	么二三
张三丰	張三丰
拼命	拚命
叮叮当当	叮叮噹噹
陪著名	陪著名
鬅松	鬅鬆
雪里蕻	雪裡蕻
杆秤	桿秤
系于	繫於
心系老	心繫老
閑著稱	閑著稱
冻	凍
咸粥	鹹粥
冲	沖
决	決
有征讨	有征討
这出身	這出身
踏著述	踏著述
嚷著述	嚷著述
六谷	六穀
戀著作	戀著作
挨著者	挨著者
冯	馮
含著書	含著書
前往	前往
庆	慶
写	寫
军	軍
农	農
五谷王南街	五谷王南街
蛋白发	蛋白發
紮著述	紮著述
困著	困着
史匹柏	史匹堡
冈	岡
亮著書	亮著書
册	冊
粉签子	粉籤子
西井里	西井里
待著作	待著作
内	內
采食	採食
官地为采	官地為寀
慣著者	慣著者
总数里	總數裡
余闲	餘閒
农历史	農歷史
采风	採風
郁火	鬱火
鲘	鮜
范贤惠	范賢惠
层	層
锈菌	鏽菌
从里向外	從裡向外
几子	几子
向著錄	向著錄
不谷	不穀
占國橋	占國橋
會干擾	會干擾
趕著作	趕著作
中签收	中簽收
制糖	製糖
𣭤	𣯴
余三胜	余三勝
六冲	六衝
商历	商曆
急著稱	急著稱
雅爾達	雅爾塔
黏著者	黏著者
畫著	畫着
峇里海	峇里海
湘累	湘纍
聽著	聽着
饥寒	饑寒
郁江	鬱江
扎营	紮營
硬體	硬件
秀发布	秀發布
余姚	餘姚
帶著者	帶著者
白霉	白黴
忙著作	忙著作
滑借	滑藉
虫	蟲
犹如表	猶如錶
虮	蟣
屯扎	屯紮
对折	對摺
拉面部	拉面部
凭几	憑几
虾	蝦
虿	蠆
自觉自愿	自覺自愿
沾化	霑化
脱	脫
颂系	頌繫
悲筑	悲筑
虑	慮
芦	蘆
吊鹤	弔鶴
虚	虛
用法里	用法裡
工具機	機床
達著名	達著名
黄岩区	黃巖區
盯著書	盯著書
咸潟	鹹潟
咏	詠
游说	遊說
手表現	手表現
脸	臉
余角	餘角
干营生	幹營生
无梁楼盖	無樑樓蓋
折尺	摺尺
𩽾	鮟
凯	凱
𩽼	鯶
𩽽	𩶱
𩽺	𩵩
𩽻	𩵹
𩽹	魥
语汇	語彙
載著錄	載著錄
克扣	剋扣
模里西斯	毛里裘斯
乔治·奥威尔	喬治·歐威爾
千只	千隻
辟辟	闢辟
下著录	下著錄
映著述	映著述
空钟	空鐘
占总	佔總
计划	計劃
折子戲	折子戲
采购	採購
余风	餘風
克期间	克期間
睡游病	睡遊病
浔	潯
松起	鬆起
酽	釅
浓	濃
浐	滻
昂山素季	昂山素姬
酱	醬
单反相机	單鏡反光機
羁	羈
浆	漿
浇	澆
浅	淺
浃	浹
連著作	連著作
浏	瀏
赤术	赤朮
骨干	骨幹
浊	濁
松散	鬆散
冶游	冶遊
浉	溮
燕游	燕遊
酝	醞
于于	于于
斗百草	鬥百草
困倦起来	困倦起來
軟體	軟件
行著者	行著者
龟鉴	龜鑑
酂	酇
鲔	鮪
丹棱	丹稜
雜著名	雜著名
薄幸	薄倖
羡	羨
茎干	莖幹
数只须	數只須
薄干	薄幹
吊奠	弔奠
凶手	兇手
垒	壘
塞普勒斯	塞浦路斯
枝干	枝幹
䅪	𥢢
三统历史	三統歷史
沖著，	沖著，
留著	留着
残余	殘餘
0周后	0周後
醜著錄	醜著錄
買凶	買兇
形单影只	形單影隻
之托	之託
荷姆茲	霍爾木茲
干着	幹着
行著書	行著書
鲖	鮦
為著	為着
浩浩荡荡	浩浩蕩蕩
于大寶	于大寶
齑	齏
齐	齊
断	斷
御寇	禦寇
斩	斬
十出祁山	十出祁山
沈大高速	瀋大高速
冬游	冬遊
脏	髒
御寒	禦寒
两虎共斗	兩虎共鬥
閑著者	閑著者
梳著錄	梳著錄
蓬松松	蓬鬆鬆
素朴	素樸
曲钱	麴錢
斋	齋
戰著述	戰著述
于國治	于國治
敦朴	敦樸
百只怕	百只怕
齿	齒
炼度	鍊度
茅于軾	茅于軾
油面	油麵
没折至	沒摺至
斓	斕
逆钟向	逆鐘向
个	個
唱著作	唱著作
涌出	湧出
垆	壚
冒著作	冒著作
花钟	花鐘
斗气	鬥氣
斗垮	鬥垮
衝着	衝着
丧	喪
進制	進制
心著書	心著書
學著書	學著書
七周后	七周後
千回百转	千迴百轉
从图里	從圖裡
5周后	5周後
墓志	墓誌
帶著述	帶著述
那只能	那只能
晚钟	晚鐘
5天后	5天後
周历史	周歷史
達著書	達著書
郁林	鬱林
䇲	筴
昂著名	昂著名
千天后	千天後
丝	絲
加薩走廊	加沙地帶
船只	船隻
要占	要佔
中签	中籤
舍本逐末	捨本逐末
斥著書	斥著書
面浆	麵漿
王鉴	王鑑
暗沟里	暗溝裡
高著作	高著作
身著述	身著述
𥬠	篘
升州	昇州
余绪	餘緒
钟座	鐘座
躍著者	躍著者
仪范	儀範
A型肝炎	甲型肝炎
英文里	英文裡
丢丑	丟醜
點著稱	點著稱
梳著名	梳著名
周游	週遊
忍著名	忍著名
彩排	綵排
零余	零餘
夸你	誇你
单向	單向
不采	不採
恶仆	惡僕
竹席	竹蓆
草荐	草荐
9周后	9周後
拉纤	拉縴
笕	筧
涌泉	湧泉
头发现	頭發現
万	萬
逼著書	逼著書
余利	餘利
自行火炮	自走炮
斗饤	鬥飣
垭	埡
心著名	心著名
购买欲	購買慾
松山庄	松山庄
悸栗	悸慄
算历	算曆
世纪钟表	世紀鐘錶
占著作	占著作
色长发	色長髮
黏著述	黏著述
瞞著者	瞞著者
斗败	鬥敗
弹珠台	彈珠檯
地占	地佔
膑	臏
姜汁	薑汁
悠游	悠遊
下签字	下簽字
罗纳尔多	朗拿度
二老板	二老板
径往	逕往
面筋	麵筋
四扎	四紮
倛丑	倛醜
余力	餘力
治愈	治癒
鸡蛋里挑骨头	雞蛋裡挑骨頭
𪉉	𪁈
郁朴	郁樸
于丹	于丹
余一	餘一
什锦面	什錦麵
吊恤	弔恤
埃菲尔	艾菲爾
憑几	憑几
伴著	伴着
满满当当	滿滿當當
𪉌	𪁖
干躁	乾躁
光著	光着
看著書	看著書
演著稱	演著稱
回复说	回覆說
喝著作	喝著作
辑	輯
辐	輻
输	輸
辒	轀
辕	轅
鹤发	鶴髮
辗	輾
辖	轄
辙	轍
辘	轆
辚	轔
复赛	複賽
量不准	量不準
辁	輇
辀	輈
较	較
辂	輅
接著名	接著名
辄	輒
辇	輦
辆	輛
辉	輝
低著錄	低著錄
辋	輞
余下	餘下
辍	輟
布陣	佈陣
辏	輳
缝	縫
擦干	擦乾
獨立國家國協	獨立國家聯合體
斗茶	鬥茶
边	邊
辽	遼
舍我其谁	捨我其誰
尚比亞	贊比亞
沃尓沃	富豪
马里兰	馬利蘭
辩	辯
辫	辮
凶相	兇相
诗余	詩餘
缓	緩
咸度	鹹度
熏染	薰染
沙烏地阿拉伯	沙特阿拉伯
有只	有隻
最多只	最多只
退伙	退夥
锈病	鏽病
万余	萬餘
于欣	于欣
走為上著	走為上着
么氏	么氏
经有云	經有云
心系您	心繫您
游船	遊船
郁热	鬱熱
峻岭	峻岭
飞行钟	飛行鐘
說著稱	說著稱
扑作教刑	扑作教刑
幫著書	幫著書
溢著述	溢著述
挨著名	挨著名
点个赞	點個讚
图里的	圖裡的
䲝	䱽
味著稱	味著稱
中签字	中簽字
之八九只	之八九只
纵欲	縱慾
确瘠	确瘠
7只支持	7只支持
睑	瞼
占臺	佔臺
缅	緬
占東	佔東
睁	睜
唱著稱	唱著稱
尽快	儘快
整出电影	整齣電影
有只是	有只是
著實	着實
零周后	零周後
瞎蒙	瞎矇
余泽	餘澤
约翰斯顿岛	強斯頓環礁
钟身	鐘身
A肝	甲肝
余波	餘波
阳	陽
0出线	0出線
阶	階
于國楨	于國楨
阴	陰
朴厚	樸厚
阊	閶
阋	鬩
阈	閾
阉	閹
因著述	因著述
阏	閼
阌	閿
阍	閽
阂	閡
阃	閫
纏著述	纏著述
纡郁	紆鬱
贪欲	貪慾
鲽	鰈
先占	先佔
阅	閱
阚	闞
阛	闤
阘	闒
阙	闕
松气	鬆氣
女仆	女僕
阒	闃
阓	闠
阐	闡
阑	闌
阖	闔
阗	闐
阔	闊
阕	闋
七情六欲	七情六慾
陪著	陪着
扁拟谷盗虫	扁擬穀盜蟲
云南个旧	雲南箇舊
斗蟋蟀	鬥蟋蟀
种師道	种師道
系上。	繫上。
䢁	𨊸
之二只	之二只
洁	潔
䢂	𨋢
羁系	羈繫
历室	曆室
試著名	試著名
斗犬	鬥犬
缫	繅
斗狗	鬥狗
五天后	五天後
心系哪	心繫哪
帛琉	帕勞
儿	兒
缭	繚
背著稱	背著稱
后发FK型星	后髮FK型星
肖斯塔科维奇	蕭士達高維契
槚	檟
滞	滯
滟	灩
面包装	面包裝
采办	採辦
好斗篷	好斗篷
滗	潷
制表键	製表鍵
茂都淀	茂都澱
阿联酋	阿聯酋
應著作	應著作
與著名	與著名
戬谷	戩穀
缣	縑
著力	着力
谷草	穀草
豎著	豎着
備著名	備著名
谷粒	穀粒
罩著	罩着
滪	澦
面包裹	面包裹
劉芸后	劉芸后
滠	灄
木签	木籤
滢	瀅
滤	濾
滥	濫
滦	灤
钟好	鐘好
丑人	醜人
隨著述	隨著述
裝著作	裝著作
抽干	抽乾
准拟	準擬
干什么	幹什麼
自由钟	自由鐘
宣布	宣佈
高涌泉	高涌泉
罗马历史	羅馬歷史
蓬发	蓬髮
丑化	醜化
秃妃之发	禿妃之髮
昆山	崑山
固征	固徵
译制	譯製
標誌著	標誌着
么麼	么麼
東協會	東協會
夸夸其谈	誇誇其談
奸夫	姦夫
䲡	鰌
彻	徹
干爸	乾爸
纤绳	縴繩
格范	格範
百个	百個
特制订	特制訂
系上黑	繫上黑
𠯟	哯
抬著	抬着
卷儿	捲兒
散伙	散夥
面包揽	面包攬
干食	乾食
累堆	纍堆
有著作	有著作
蓋著作	蓋著作
支配欲	支配慾
难舍	難捨
俭仆	儉僕
涌入	湧入
斗嘴	鬥嘴
冲锋枪	衝鋒鎗
团子	糰子
與著錄	與著錄
黄钰筑	黃鈺筑
丑闻	醜聞
肾脏	腎臟
白干儿	白乾兒
信息时代	資訊時代
忠人之托	忠人之托
蹒局	蹣跼
蒙雾露	蒙霧露
披著述	披著述
占在	佔在
昭惠后	昭惠后
多只含	多只含
占场	佔場
发姐	髮姐
铈	鈰
赌后	賭后
占地	佔地
搀	攙
簽著	簽着
小型钟面	小型鐘面
李适	李适
發著名	發著名
占國	佔國
夸毗	誇毗
搂	摟
棱锥	稜錐
征集	徵集
雪窗萤几	雪窗螢几
药面儿	藥麵兒
禅	禪
摟著作	摟著作
自制地	自制地
考试制度	考試制度
備著書	備著書
蛮	蠻
畫著者	畫著者
制片	製片
里氏震级	黎克特制震級
一干弟兄	一干弟兄
龙眼干	龍眼乾
姜啤	薑啤
鲫	鯽
樂著書	樂著書
蛲	蟯
蛳	螄
草丛里	草叢裡
蛱	蛺
跑著	跑着
費占	費佔
過著者	當著者
逆著者	逆著者
姜饼	薑餅
蛏	蟶
留长发	留長髮
花药	花葯
鬓	鬢
痳木	痳木
斗话	鬥話
采珠	採珠
防锈	防鏽
节目里	節目裡
独辟蹊径	獨闢蹊徑
征到	徵到
耧	耬
夸姣	誇姣
耀著述	耀著述
托卖	託賣
油泼面	油潑麵
伏著	伏着
万年历表	萬年曆錶
希伯来历史	希伯來歷史
肖邦	蕭邦
空荡	空蕩
密布	密佈
换签	換籤
擔著	擔着
余味	餘味
纤手	縴手
宝里宝气	寶裡寶氣
、面点	、麵點
余8	餘8
余9	餘9
两杆	兩桿
于山國	于山國
府干涉	府干涉
余2	餘2
余3	餘3
余0	餘0
荧屏	螢屏
发霜	髮霜
盯著者	盯著者
余4	餘4
麥克風	咪高峰
红发	紅髮
下著称	下著稱
嶒棱	嶒稜
手表达	手表達
赌台	賭檯
代表	代表
那只应	那只應
鉴定	鑑定
舍己救人	捨己救人
熏风	薰風
喝干	喝乾
葉爾欽	葉利欽
姜母	薑母
咎征	咎徵
扑打	扑打
江并流	江併流
断发文身	斷髮文身
放著	放着
馆里	館裡
拿著錄	拿著錄
体里	體裡
奴仆	奴僕
粝	糲
浚县	濬縣
𢫞	𢶫
法自制	法自制
味著述	味著述
夸别	誇別
布雷封鎖	佈雷封鎖
不寒而栗	不寒而慄
赍	齎
台州	台州
心著稱	心著稱
划了一会	划了一會
罵著錄	罵著錄
展著者	展著者
齿落发白	齒落髮白
不斗膽	不斗膽
到山里	到山裡
八余	八餘
沉著書	沉著書
手折	手摺
繞著錄	繞著錄
向往来	向往來
懔	懍
身著書	身著書
谷食	穀食
彩牌樓	綵牌樓
虮虱相吊	蟣蝨相弔
舍安就危	捨安就危
雄斗斗	雄斗斗
大周折	大週摺
鳛	鰼
鳚	䲁
鳙	鱅
云里雾里	雲裡霧裡
配图里	配圖裡
跌扑	跌扑
鳝	鱔
鳜	鱖
轉著書	轉著書
鳒	鰜
鳑	鰟
鳐	鰩
鳗	鰻
鳖	鱉
洒濯	洒濯
只身段	只身段
鳋	鰠
鳊	鯿
鳉	鱂
鳈	鰁
咸食	鹹食
偷著稱	偷著稱
鳍	鰭
鳌	鰲
占頭	佔頭
鳂	鰃
鳁	鰮
鲦	鰷
鳇	鰉
盯著	盯着
鳅	鰍
鳄	鱷
杠毂	杠轂
占蘇	佔蘇
2周后	2周後
3只支持	3只支持
占領	佔領
六只	六隻
买断发	買斷發
占便宜	佔便宜
迂回	迂迴
鳣	鱣
鳢	鱧
鳡	鱤
鳠	鱯
注：	註：
鳤	䲘
矿	礦
矾	礬
干饭	乾飯
矶	磯
矫	矯
魏征	魏徵
颂赞	頌讚
厘正	釐正
于仲文	于仲文
𪡏	嗹
占查	佔查
一干家中	一干家中
𥺅	䊭
准拿督	準拿督
配著	配着
拉面前	拉面前
髮踊沖冠	髮踊沖冠
相克服	相克服
玉历	玉曆
紮著書	紮著書
鞯	韉
撒切尔	戴卓爾
干劲	幹勁
密西根	密歇根
内制	內製
并线	併線
為著作	為著作
辟室	闢室
禁欲主义	禁欲主義
掙著稱	掙著稱
铲刈	剷刈
游历	遊歷
干办	幹辦
丑虏	醜虜
提著錄	提著錄
鞑	韃
鞒	鞽
落著名	落著名
上签名	上簽名
金表态	金表態
猶豫著	猶豫着
炸酱面	炸醬麵
占著稱	占著稱
凄惋	悽惋
干乔	乾喬
采回	採回
刻著述	刻著述
开诚布公	開誠佈公
谷氨	穀氨
老干	老乾
绕梁	繞樑
鬶	鬹
日历史	日歷史
凄惶	悽惶
凄惨	悽慘
守著書	守著書
于非暗	于非闇
福著書	福著書
得著名	得著名
咬著	咬着
昂著書	昂著書
寿面	壽麵
持著名	持著名
擺著名	擺著名
忾	愾
忧	憂
蒙特內哥羅	黑山
未干涉	未干涉
黎吉雲	黎吉雲
占多	佔多
福著稱	福著稱
占大	佔大
制衣	製衣
肯尼迪	甘迺迪
硬件	硬件
管著者	管著者
占头	佔頭
圣人历	聖人曆
采芹人	採芹人
忏	懺
天历史	天歷史
干虔	乾虔
猪	豬
鹴	鸘
于奇库杜克	于奇庫杜克
驻扎	駐紮
面点、	麵點、
横峰县	橫峯縣
盐卤	鹽滷
著你	着你
斗智	鬥智
數著錄	數著錄
后稷	后稷
索面	索麵
捣	搗
隆准许	隆准許
趕著者	趕著者
𤈷	㷿
采信	採信
困斗	困鬥
赞羡	讚羨
㛟	𡞵
慣著作	慣著作
乘著名	乘著名
展著述	展著述
雙胜類	雙胜類
㛀	媰
夜晚里	夜晚裡
啰苏	囉囌
提著作	提著作
吉凶庆吊	吉凶慶弔
周游列国	周遊列國
奸妇	姦婦
㛿	𡠹
自制服	自制服
面包起	面包起
韦席	韋蓆
㛤	孋
揉著者	揉著者
陳杰	陳杰
㛠	𡢃
卷动	捲動
下著述	下著述
斗争斗合	鬥爭鬥合
飘飘荡荡	飄飄蕩蕩
郁陶	鬱陶
协防	協防
谛	諦
对准表	對準錶
谙	諳
與著者	與著者
谟	謨
黃詩杰	黃詩杰
谝	諞
思如泉涌	思如泉湧
谓	謂
物欲	物慾
谑	謔
谐	諧
谗	讒
谖	諼
谕	諭
谔	諤
谋	謀
两个	兩個
綁著	綁着
谈	談
谏	諫
谎	謊
谍	諜
谌	諶
俦	儔
見著者	見著者
谁	誰
谀	諛
谇	誶
谆	諄
谅	諒
机器人	機械人
朴学	樸學
控制	控制
栋梁	棟樑
谲	譎
谱	譜
谰	讕
谶	讖
径到	逕到
六楼后座	六樓后座
谫	譾
谪	謫
干掉	幹掉
谨	謹
谯	譙
谮	譖
谭	譚
谬	謬
谣	謠
谢	謝
谡	謖
抵御	抵禦
谧	謐
美发学	美髮學
谥	諡
谤	謗
腊味	腊味
锦卤	錦滷
干圆洁净	乾圓潔淨
坐台铁	坐台鐵
系鞋带	繫鞋帶
動著書	動著書
面点师	麵點師
贝克汉姆	碧咸
赪	赬
涌起	湧起
会吊	會弔
向导	嚮導
怒气冲天	怒氣衝天
罵著者	罵著者
老懞	老懞
靠著	靠着
罩著述	罩著述
引发	引發
0出	0齣
席子	蓆子
馬爾地夫	馬爾代夫
高干	高幹
干子	乾子
𦈑	緸
牽著	牽着
燒著稱	燒著稱
更仆难数	更僕難數
蝾	蠑
咸甜	鹹甜
唱著名	唱著名
戀著名	戀著名
移动网络	流動網絡
蝎	蠍
松元音	鬆元音
蝉	蟬
游轮	遊輪
跪著稱	跪著稱
蝇	蠅
受著作	受著作
干季	乾季
窝里	窩裡
刮倒	颳倒
冲到	衝到
備著	備着
复壁	複壁
压制机	壓製機
撇吊	撇弔
帶著錄	帶著錄
對著名	對著名
小只	小隻
姜蓉	薑蓉
病余	病餘
有征討	有征討
警示钟	警示鐘
并发动	並發動
冲天炮	衝天炮
进制	進制
只身高	只身高
外强中干	外強中乾
并吞	併吞
赃	贓
努力著稱	努力著稱
亮著	亮着
通奸	通姦
伙众	夥眾
順著	順着
绷扒吊拷	繃扒弔拷
跟著作	跟著作
5余	5餘
并名	併名
没准	沒準
赎	贖
聚药雄蕊	聚葯雄蕊
并合	併合
弃舍	棄捨
捆扎	綑紮
犯不著	犯不着
腕表	腕錶
伣	俔
疑凶	疑兇
传	傳
伧	傖
伦	倫
做著書	做著書
冲风	衝風
伫	佇
伪	偽
拎著名	拎著名
傥	儻
桢干	楨幹
众	眾
盒里	盒裡
河岳	河嶽
赋范	賦范
会	會
返朴	返樸
卷纸	捲紙
傩	儺
山谷	山谷
騎著作	騎著作
赗	賵
天后	天后
村落发	村落發
史蒂芬·史匹柏	史提芬·史匹堡
赓	賡
皇历史	皇歷史
府干扰	府干擾
占资	佔資
鬓发	鬢髮
郁垒	鬱壘
𫌨	覼
湾	灣
邱于庭	邱于庭
占起	佔起
才干预	才干預
鸡只	雞隻
希特勒	希特拉
蓋亞那	圭亞那
游子	遊子
多只会	多只會
𫌀	襀
有仆	有僕
赚	賺
回形夹	迴形夾
谷苗	穀苗
因著《	因著《
纯	純
因著〈	因著〈
纭	紜
涂逢年	涂逢年
彩线	綵綫
纨	紈
纩	纊
约	約
级	級
纤	纖
雅著書	雅著書
红	紅
𤳄	𤳸
纠	糾
纡	紆
炽	熾
干癣	乾癬
纼	紖
纽	紐
纺	紡
纻	紵
纸	紙
纹	紋
纶	綸
纷	紛
纴	紝
纵	縱
纲	綱
纳	納
纰	紕
纱	紗
庙	廟
演化論	進化論
美发沙龙	美髮沙龍
纟	糹
身体发肤	身體髮膚
护发	護髮
困倦	睏倦
夢著述	夢著述
阴历	陰曆
这伙人	這夥人
历狱	曆獄
玉历史	玉歷史
白净面皮	白淨面皮
䁖	瞜
欲火	慾火
暧	曖
吊喭	弔喭
鱽	魛
鱼	魚
鱿	魷
鱾	魢
著陸	着陸
辦著名	辦著名
掖著述	掖著述
呵喂	呵喂
黎克特制	黎克特制
剃胡	剃鬍
两只	兩隻
占领	佔領
打著名	打著名
绘制	繪製
捆著作	捆著作
戀著稱	戀著稱
么元	么元
二不棱登	二不稜登
哄堂大笑	哄堂大笑
印表機	打印機
阳历史	陽歷史
钟响	鐘響
么兒	么兒
狂并潮	狂併潮
斗风	鬥風
余悸	餘悸
干井	乾井
冗余	冗餘
紮著錄	紮著錄
丑夷	醜夷
雅著者	雅著者
罗纳德·里根	朗奴·列根
怨气冲天	怨氣衝天
片里	片裡
十天后	十天後
诬蔑	誣衊
石梁	石樑
壶	壺
钟磬	鐘磬
四个	四個
懷著書	懷著書
干电	乾電
回文诗	迴文詩
擺著者	擺著者
粤	粵
苑里	苑裡
涼著述	涼著述
水里鄉	水里鄉
词余	詞餘
叫著者	叫著者
瞞著書	瞞著書
声	聲
征婚	徵婚
钟不撞不鸣	鐘不撞不鳴
豎著錄	豎著錄
雜著稱	雜著稱
沈州	瀋州
沈北	瀋北
征询	徵詢
采光	採光
长历	長曆
钟律	鐘律
对表中	對表中
打著述	打著述
伴游	伴遊
赕	賧
车里雅宾斯克	車里雅賓斯克
延历	延曆
注标	註標
索馬利里	索馬里
侵并	侵併
幹著名	幹著名
采行	採行
这只用	這只用
那只不过	那只不過
埃及艳后	埃及豔后
凭折	憑摺
秋游	秋遊
录	錄
当	當
归	歸
東協	東盟
彟	彠
格斗	格鬥
大多只	大多只
里弦	裡弦
礼赞	禮讚
刮风	颳風
厄瓜多	厄瓜多爾
显示表明	顯示表明
表冠	錶冠
數著者	數著者
烫发	燙髮
镜图里	鏡圖裡
布里海	布里海
曲霉	麴黴
腌臢	腌臢
愛著	愛着
6天后	6天後
村里有	村裡有
繞著稱	繞著稱
粮	糧
制程	製程
燕几	燕几
奥占	奧佔
回游	回遊
屋梁	屋樑
高著称	高著稱
偷著	偷着
老爷钟	老爺鐘
淬炼	淬鍊
忍著書	忍著書
方向	方向
制著者	制著者
𩾃	鮸
空著書	空著書
昂著稱	昂著稱
挨著作	挨著作
𩾁	鯄
肺脏	肺臟
准谱	準譜
俭确之教	儉确之教
借故	藉故
揉著錄	揉著錄
于建嵘	于建嶸
采撷	採擷
閉著錄	閉著錄
只占神问卜	只占神問卜
龛	龕
齿危发秀	齒危髮秀
占道	佔道
钱谷	錢穀
系列里	系列裡
面码儿	麵碼兒
爭著錄	爭著錄
走著稱	走著稱
累绁	纍紲
逋发	逋髮
烏龍麵	烏冬麵
广	廣
荐臻	荐臻
鄉愿	鄉愿
于山国	于山國
公干	公幹
游手好闲	遊手好閒
疑著書	疑著書
扑咚	撲鼕
心系高	心繫高
偷著作	偷著作
撼著述	撼著述
伊郁	伊鬱
踩著述	踩著述
余孽	餘孽
見著稱	見著稱
卷烟盒	捲煙盒
警戒著	警戒着
美容美发	美容美髮
里海崖	里海崖
口腹之欲	口腹之慾
。个中	。箇中
电钟	電鐘
余子	餘子
咸得	鹹得
頂著稱	頂著稱
带余	帶餘
台子孙	台子孫
毫厘	毫釐
余存	餘存
天文学钟	天文學鐘
得著述	得著述
签幐	籤幐
饥溺	饑溺
变丑	變醜
痨	癆
信著称	信著稱
转斗千里	轉鬥千里
眼里	眼裡
木材干馏	木材乾餾
古人有云	古人有云
府干预	府干預
斗叶子	鬥葉子
马斯垂克期	馬斯垂克期
正文里	正文裡
釀著作	釀著作
迭代	疊代
蒙松雨	矇松雨
腐余	腐餘
著鞭	着鞭
𫓧	鈇
余数	餘數
门里	門裡
𫓩	鏦
伊斯兰教历	伊斯蘭教曆
霡	霢
癞	癩
霭	靄
凌蒙初	凌濛初
游刃	遊刃
咯当	咯噹
癣	癬
雇人	僱人
圣基茨和尼维斯	聖吉斯納域斯
标签	標籤
癫	癲
配著作	配著作
史瓦濟蘭	斯威士蘭
于光新	于光新
于式枚	于式枚
显示钟表	顯示鐘錶
地心历表	地心曆表
于魁智	于魁智
熏沐	薰沐
勤仆	勤僕
侥	僥
侧	側
占澳	佔澳
历元	曆元
侠	俠
侣	侶
系结	繫結
侬	儂
侩	儈
侨	僑
侪	儕
緝凶	緝兇
藏蒙歌儿	藏矇歌兒
稀松	稀鬆
心系富	心繫富
干性油	幹性油
語著書	語著書
辞	辭
嚴云農	嚴云農
债	債
系绳	繫繩
郁邑	鬱邑
藏著作	藏著作
腾涌	騰湧
划龙舟	划龍舟
本著	本着
朴修斯	樸修斯
范文瀾	范文瀾
剃发	剃髮
占資	佔資
B型肝炎	乙型肝炎
潤著書	潤著書
托附	託附
南回铁路	南迴鐵路
拂钟无声	拂鐘無聲
海淀山後	海淀山後
唱著錄	唱著錄
划龙船	划龍船
能干政	能干政
浮荡	浮蕩
濒	瀕
哭著述	哭著述
肯尼亚	肯雅
斗巧	鬥巧
面包着	面包著
茶余	茶餘
于素秋	于素秋
准是	準是
于樂	于樂
装折	裝摺
更钟	更鐘
干蛊	幹蠱
采住	採住
候著錄	候著錄
战斗	戰鬥
佣鈿	佣鈿
托身	託身
干白葡萄酒	乾白葡萄酒
蒸制	蒸製
症结	癥結
魔表	魔錶
天里	天裡
局蹐	跼蹐
单干	單幹
朴讷	樸訥
准星	準星
节余	節餘
斗起	鬥起
郁金	鬱金
辅	輔
用著者	用著者
于斯塔德	于斯塔德
神雕像	神雕像
占六	佔六
占八	佔八
占全	佔全
占兩	佔兩
模棱	模稜
心愿	心愿
范賢惠	范賢惠
尧	堯
脺脏	脺臟
枢	樞
断发	斷髮
蒙著作	蒙著作
沿溯	沿泝
金溪县	金谿縣
采金	採金
占先	佔先
占光	佔光
布雷、	佈雷、
百炼	百鍊
皺著	皺着
裹著錄	裹著錄
夸我	誇我
母范	母範
气	氣
著他	着他
醯醬	醯醬
伴著作	伴著作
醯醢	醯醢
这只应	這只應
著什	着什
松松地	鬆鬆地
枨	棖
族里	族裡
愤	憤
卷发	捲髮
醯醋	醯醋
庄里	莊裡
那只会	那只會
卷成	捲成
庐	廬
仆姑	僕姑
停停当当	停停當當
伏几	伏几
冲州撞府	衝州撞府
余罪	餘罪
飃著	飃着
张勋	張勳
叶恭弘	叶恭弘
敬挽	敬輓
辈	輩
人发指	人髮指
啊喂	啊喂
鹄发	鵠髮
活著	活着
瞪著述	瞪著述
征结	徵結
弄松	弄鬆
語著錄	語著錄
米余	米餘
飞	飛
丑辞	醜辭
斯坦福大学	史丹福大學
海洛因	海洛英
腘	膕
二只	二隻
壸范	壼範
廢后	廢后
守著作	守著作
呼吁	呼籲
秀发现	秀發現
拉面色	拉面色
罩著稱	罩著稱
丑辱	醜辱
沈丹线	瀋丹線
鸿范	鴻範
沈海高速	瀋海高速
愿	願
蟏	蠨
哗然	譁然
浮著述	浮著述
各辟	各闢
拌面	拌麵
醇朴	醇樸
买	買
集游法	集遊法
悶著	悶着
借著稱	借著稱
蒙蒙细雨	濛濛細雨
柜台	櫃檯
准据	準據
海上布雷	海上佈雷
冁	囅
碧河里	碧河里
相冲	相衝
别拗	彆拗
复测	複測
背著	背着
黏著書	黏著書
幫著名	幫著名
冲着	衝着
复流	複流
躺著名	躺著名
金城里	金城里
得著	得着
𣆐	曥
飄著作	飄著作
辎	輜
游戏	遊戲
伊东怜	伊東怜
于鳳桐	于鳳桐
著想	着想
采给	採給
坏	壞
广征	廣徵
老干部	老幹部
郁愤	鬱憤
渐	漸
梅鐸	梅鐸
习	習
饭团	飯糰
貝克漢	碧咸
圍著書	圍著書
大只需	大只需
古柯咸	古柯鹹
采挖	採挖
燒著者	燒著者
持著作	持著作
坐著述	坐著述
复式	複式
星历史	星歷史
斗头	鬥頭
有回复	有回覆
浮著書	浮著書
云吞面	雲吞麵
坐著	坐着
于敏	于敏
乔	喬
钟乳洞	鐘乳洞
擞	擻
聖文森及格瑞那丁	聖文森特和格林納丁斯
支干	支幹
扎好	紮好
这钟	這鐘
礼	禮
后丰	后豐
烤干	烤乾
卷住	捲住
丑时	丑時
聽著錄	聽著錄
烫次发	燙次髮
九余	九餘
于從濂	于從濂
升平	昇平
跟著者	跟著者
么	麼
來著	來着
坠	墜
哗众	譁眾
昼	晝
显	顯
警钟	警鐘
于荣光	于榮光
余欢	餘歡
睡著名	睡著名
糕干	糕乾
跳著者	跳著者
摸棱	摸稜
余款	餘款
泪干	淚乾
稳占	穩佔
本著名	本著名
考著述	考著述
手表露	手表露
𢘞	𢣭
𢘝	𢣚
踩著稱	踩著稱
种谷	種穀
积谷防饥	積穀防饑
马格里布	馬格里布
著艦	着艦
煮面	煮麵
干才	幹才
府干預	府干預
挑大梁	挑大樑
著色	着色
瞪著書	瞪著書
拙朴	拙樸
心系功	心繫功
卤湖	滷湖
胡子昂	胡子昂
外制	外製
冲进	衝進
无余	無餘
心系动	心繫動
后妃	后妃
须发	鬚髮
干拌面	乾拌麵
托里县	託里縣
卤蛋	滷蛋
钸	鈽
钹	鈸
钺	鉞
游动	遊動
钼	鉬
钽	鉭
钾	鉀
舍近求远	捨近求遠
钰	鈺
钱	錢
钲	鉦
钳	鉗
钴	鈷
洪适	洪适
钶	鈳
钷	鉕
担仔面	擔仔麵
回圈	迴圈
钪	鈧
制药	製藥
钬	鈥
钭	鈄
钮	鈕
钯	鈀
钠	鈉
钡	鋇
钢	鋼
钣	鈑
沉著名	沉著名
钥	鑰
盗	盜
哒	噠
钘	鈃
钙	鈣
钚	鈈
钛	鈦
钜	鉅
钝	鈍
钞	鈔
钟	鍾
疑著者	疑著者
那只包括	那只包括
钒	釩
暗著	暗着
钔	鍆
钕	釹
钖	鍚
钗	釵
瞞著稱	瞞著稱
钟调	鐘調
钊	釗
钋	釙
钌	釕
钍	釷
钎	釺
钏	釧
辣面	辣麵
钆	釓
钇	釔
简短发	簡短發
小只会	小只會
纳征	納徵
立著作	立著作
涌来	湧來
爱荷华	艾奧瓦
數著作	數著作
系囚	繫囚
吃不著	吃不着
回复你	回覆你
咸肉	鹹肉
冲浪	衝浪
复方	複方
谈征	談徵
裹著	裹着
那里	那裡
抱著述	抱著述
积谷	積穀
擡著	擡着
红绳系足	紅繩繫足
提著稱	提著稱
繫著	繫着
廪	廩
𩧪	䮾
閑著書	閑著書
滨田里佳子	濱田里佳子
曲道士	麴道士
拧干	擰乾
费米面	費米面
卷铺盖	捲鋪蓋
达	達
会占	會佔
请托	請託
泰山梁木	泰山梁木
古朴	古樸
占場	佔場
并发表	並發表
诇	詗
缉凶	緝兇
心系幼	心繫幼
歌钟	歌鐘
鋪著者	鋪著者
𩧬	𩢡
只影	隻影
么舅	么舅
万俟	万俟
注记	註記
映著	映着
显示表示	顯示表示
心系的	心繫的
光著者	光著者
诀	訣
髼松	髼鬆
背地里	背地裡
游魂	遊魂
𩧨	駎
拎著作	拎著作
𩧩	𩤊
举手表	舉手表
诌	謅
心理	心理
干不了	幹不了
𩧫	駚
蓄发	蓄髮
古迹	古蹟
历日	曆日
后角	后角
身著錄	身著錄
欲令智昏	慾令智昏
诋	詆
于震前	於震前
𩧮	𩢾
电影里	電影裡
卷去	捲去
朴钝	樸鈍
𩧯	驋
皮肤	皮膚
舍弃	捨棄
诗	詩
𩧲	駧
同人志	同人誌
塗著	塗着
诒	詒
九谷	九穀
㟜	𡾱
𩧵	𩢴
彩帶	綵帶
精制伏	精制伏
败	敗
雕梁画栋	雕樑畫棟
责	責
诐	詖
贡	貢
至多	至多
贯	貫
贮	貯
购	購
贬	貶
贫	貧
贪	貪
贩	販
质	質
彩带	綵帶
贶	貺
贵	貴
须眉	鬚眉
复辅音	複輔音
考著書	考著書
贱	賤
贰	貳
贿	賄
贾	賈
贽	贄
贼	賊
马干	馬乾
贺	賀
费	費
贸	貿
𩧻	𩣵
回旋	迴旋
𩧼	𩣺
吹干	吹乾
戴著者	戴著者
鼻准	鼻準
负	負
贞	貞
贝	貝
𢽾	斅
騙著名	騙著名
万一只	萬一只
蘸著	蘸着
冲锋	衝鋒
综合征	綜合徵
鬼气冲天	鬼氣衝天
側著名	側著名
该	該
百拙千丑	百拙千醜
回采	回採
𩧳	𩢸
印著錄	印著錄
积郁	積鬱
心系香	心繫香
征车	徵車
耳余	耳餘
刮著	刮着
蛏干	蟶乾
𩧴	駩
九个	九個
还采	還採
葱	蔥
采铁	採鐵
綁著稱	綁著稱
喂喲	喂喲
點著作	點著作
语云	語云
松软	鬆軟
巴倫西亞	華倫西亞
回避	迴避
口干冒	口干冒
美占	美佔
擊劍	劍擊
休克期	休克期
霁范	霽範
钟王	鐘王
复始	復始
备注	備註
这只需	這只需
才干戈	才干戈
发丝	髮絲
據著書	據著書
于榮光	于榮光
诿	諉
复姓	複姓
林宏岳	林宏嶽
连系	連繫
硚	礄
吹著	吹着
田子里	田子里
卜云吉	卜云吉
披著稱	披著稱
游览	遊覽
硖	硤
轨范	軌範
诹	諏
举	舉
签诗	籤詩
乘著	乘着
村里的	村裡的
为	為
𤊀	𤒎
管制	管制
临	臨
基干	基幹
丰	豐
暗斗	暗鬥
垅	壠
柴契爾	戴卓爾
噙齿戴发	噙齒戴髮
貝爾格勒	貝爾格萊德
严	嚴
两	兩
面包办	面包辦
丢	丟
拜托	拜託
著絲	着絲
義联	義联
垲	塏
东	東
丛	叢
涂壯勳	涂壯勳
美著称	美著稱
一出喜剧	一齣喜劇
虽	雖
与	與
志庆	誌慶
垦	墾
筑波	筑波
垩	堊
垫	墊
卤料	滷料
心系子	心繫子
隨著錄	隨著錄
盯著述	盯著述
𪞝	凙
淀山	澱山
乘著書	乘著書
干生子	乾生子
潴	瀦
要冲	要衝
干么	幹麼
西臺王	赫梯王
潍	濰
潋	瀲
潆	瀠
潇	瀟
跟著名	跟著名
个旧市	箇舊市
稆	穭
染殿后	染殿后
睡著者	睡著者
潜	潛
忍著	忍着
蒙著錄	蒙著錄
柜上	柜上
管著	管着
欲海	慾海
一伙食	一伙食
雕鹗	鵰鶚
离	離
注销	註銷
中签名	中簽名
卤虾	滷蝦
厘改	釐改
虏	虜
于荫霖	于蔭霖
占6	佔6
占7	佔7
占4	佔4
占5	佔5
占2	佔2
占3	佔3
占0	佔0
占1	佔1
文莱	汶萊
御制	御製
占8	佔8
占9	佔9
作品里	作品裡
髯胡	髯鬍
借著書	借著書
辦著	辦着
禀	稟
心系小	心繫小
禄	祿
圍著稱	圍著稱
占V	佔V
占W	佔W
占T	佔T
占U	佔U
占R	佔R
占S	佔S
占P	佔P
占Q	佔Q
䝙	貙
就里	就裡
占Z	佔Z
占X	佔X
占Y	佔Y
占F	佔F
占G	佔G
占D	佔D
占E	佔E
占B	佔B
占C	佔C
心系我	心繫我
占A	佔A
占N	佔N
占O	佔O
占L	佔L
占M	佔M
占J	佔J
占K	佔K
占H	佔H
占I	佔I
迈克尔	米高
結彩	結綵
彩綢	綵綢
余殃	餘殃
看著	看着
沟谷	溝谷
踩著者	踩著者
熏习	薰習
西臺語	赫梯語
哄笑	鬨笑
開著作	開著作
筑北	筑北
谷仓	穀倉
丑末	醜末
二个	二個
揮著錄	揮著錄
七天后	七天後
約占	約佔
悠著作	悠著作
余威德	余威德
索尔仁尼琴	索贊尼辛
木偶戏扎	木偶戲紮
賓·拉登	本·拉登
聖后	聖后
手表面	手表面
咚咚鼓	鼕鼕鼓
斗争	鬥爭
心系西	心繫西
占国桥	占國橋
山羊胡	山羊鬍
稣	穌
斗了	鬥了
当啷	噹啷
受著稱	受著稱
港制	港製
干没	乾沒
受托	受託
一伙	一夥
干沟	乾溝
于凌辰	于凌辰
束发	束髮
附注	附註
忠仆	忠僕
𪻐	瑽
交托	交託
么妹	么妹
日占	日佔
之一只	之一只
手表决	手表決
朴马	樸馬
五谷	五穀
采石矶	采石磯
昂著	昂着
斥著者	斥著者
想著作	想著作
𦟗	𦣎
掙著者	掙著者
面條目	面條目
果子干	果子乾
冲波	衝波
永志不忘	永誌不忘
扎铁	紮鐵
镄	鐨
蒙著稱	蒙著稱
活著述	活著述
靠著稱	靠著稱
視著作	視著作
菜坛	菜罈
头长发	頭長髮
茑	蔦
况	況
弹子台	彈子檯
东周钟	東周鐘
擺著錄	擺著錄
領著書	領著書
钟相	鐘相
過著書	當著書
昆曲	崑曲
㲿	瀇
占不占	佔不佔
蒙特婁	蒙特利爾
代表著作	代表著作
干逼	乾逼
里带	裡帶
搜索引擎	搜尋引擎
本庄	本庄
径迎	逕迎
万天后	萬天後
提著	提着
𣸣	濆
窗帘	窗簾
极	極
勋绩	勳績
隆准	隆準
走著	走着
铲除	剷除
枞	樅
占香	佔香
克死	剋死
印著述	印著述
枧	梘
枥	櫪
枣	棗
稳健的台风	穩健的台風
枭	梟
䜩	讌
枫	楓
枪	槍
占馬	佔馬
郁蓊	鬱蓊
躍著書	躍著書
拆伙	拆夥
推托之词	推托之詞
采掘	採掘
么正	么正
啮虫	囓蟲
九天后	九天後
笑著錄	笑著錄
诸余	諸餘
𩽿	𩶰
几案	几案
面包围	面包圍
纪历	紀曆
米沈	米瀋
扎裹	紮裹
樵采	樵採
回环	迴環
衣著名	衣著名
什勒斯維希	石勒蘇益格
巷里	巷裡
舍生	捨生
𫗠	餦
模范三軍	模范三軍
𨀱	𨄣
曲秀才	麴秀才
房里	房裡
波士尼亞	波斯尼亞
趱	趲
近日无仇	近日無讎
制著錄	制著錄
钟盘	鐘盤
趋	趨
山棱	山稜
干儿	乾兒
爰定祥历	爰定祥厤
发	發
斗脚	鬥腳
怜奈	怜奈
风卷残云	風捲殘雲
二里頭	二里頭
連占	連佔
火拼	火拚
准军事	準軍事
黏著錄	黏著錄
昂著錄	昂著錄
𩨌	𩥑
𩨏	䮳
𩨎	龭
𩨉	𩤲
布道	佈道
𩨋	𩥄
𩨊	騚
𩨅	𩤸
𩨄	騪
抓著名	抓著名
𩨆	𩤙
𩨁	䮞
见钟不打	見鐘不打
𩨃	騝
抑制	抑制
余倍	餘倍
朱庆余	朱慶餘
母后	母后
摆钟	擺鐘
面糊	麵糊
啷当	啷噹
管著作	管著作
开哄	開鬨
咸土	鹹土
车库里	車庫裡
應著稱	應著稱
夸多斗靡	誇多鬥靡
幂	冪
洞里薩	洞里薩
复活节历表	復活節曆表
号志	號誌
鞣制	鞣製
地图里	地圖裡
松喉	鬆喉
干等	乾等
斗分子	鬥分子
启发式	啟發式
短几	短几
牽著者	牽著者
意占	意佔
占整	佔整
占个位	佔個位
并	並
谬采虚声	謬採虛聲
展著書	展著書
幸存	倖存
幺	么
說著	說着
𫗴	饘
賓士	平治
一伙头	一伙頭
被发左衽	被髮左衽
淀解物	澱解物
𫗦	餔
角落里	角落裡
吐瓦魯	圖瓦盧
个中理由	箇中理由
𫗮	餭
象征	象徵
雅著名	雅著名
铸钟	鑄鐘
煴	熅
发癣	髮癬
风刮	風颳
𥺇	𥽖
擋著錄	擋著錄
丑样	醜樣
兆余	兆餘
哟喂	喲喂
